state_name,county_fips,county_name,votes_gop,votes_dem,total_votes,diff,per_gop,per_dem,per_point_diff
Alabama,1001,Autauga County,20484,7439,28190,13045,0.726640653,0.263887904,0.462752749
Alabama,1003,Baldwin County,95798,24934,121808,70864,0.786467227,0.204699199,0.581768028
Alabama,1005,Barbour County,5606,4158,9832,1448,0.570179007,0.422904801,0.147274207
Alabama,1007,Bibb County,7572,1619,9241,5953,0.819391841,0.175197489,0.644194351
Alabama,1009,Blount County,25354,2576,28115,22778,0.901796194,0.091623688,0.810172506
Alabama,1011,Bullock County,1101,2983,4106,-1882,0.268144179,0.726497808,-0.458353629
Alabama,1013,Butler County,5172,3251,8467,1921,0.610842093,0.383961261,0.226880831
Alabama,1015,Calhoun County,34912,13194,48530,21718,0.719390068,0.271873068,0.447517
Alabama,1017,Chambers County,8711,5405,14221,3306,0.612544828,0.380071725,0.232473103
Alabama,1019,Cherokee County,11358,1553,12984,9805,0.874768946,0.119608749,0.755160197
Alabama,1021,Chilton County,16920,2698,19728,14222,0.857664234,0.136759935,0.720904298
Alabama,1023,Choctaw County,4103,2515,6646,1588,0.617363828,0.378423112,0.238940716
Alabama,1025,Clarke County,6965,4927,11946,2038,0.583040348,0.41243931,0.170601038
Alabama,1027,Clay County,5734,993,6757,4741,0.84860145,0.146958709,0.701642741
Alabama,1029,Cleburne County,6988,605,7637,6383,0.915018987,0.079219589,0.835799398
Alabama,1031,Coffee County,17495,4601,22270,12894,0.78558599,0.206600808,0.578985182
Alabama,1033,Colbert County,19714,7137,27086,12577,0.727829875,0.263494056,0.464335819
Alabama,1035,Conecuh County,3423,2580,6043,843,0.56644051,0.426940261,0.139500248
Alabama,1037,Coosa County,3758,1478,5264,2280,0.713905775,0.280775076,0.433130699
Alabama,1039,Covington County,14677,2314,17072,12363,0.859711809,0.13554358,0.724168229
Alabama,1041,Crenshaw County,5000,1457,6480,3543,0.771604938,0.224845679,0.546759259
Alabama,1043,Cullman County,38704,4039,43052,34665,0.899005853,0.09381678,0.805189074
Alabama,1045,Dale County,14476,4484,19103,9992,0.757786735,0.23472753,0.523059205
Alabama,1047,Dallas County,5190,10236,15528,-5046,0.33423493,0.659196291,-0.32496136
Alabama,1049,DeKalb County,25633,3758,29583,21875,0.866477369,0.127032417,0.739444951
Alabama,1051,Elmore County,31374,9774,41491,21600,0.756163987,0.23556916,0.520594828
Alabama,1053,Escambia County,10884,3964,14929,6920,0.729050841,0.265523478,0.463527363
Alabama,1055,Etowah County,35653,10027,46023,25626,0.774677878,0.217869326,0.556808552
Alabama,1057,Fayette County,7158,1142,8356,6016,0.856629966,0.136668262,0.719961704
Alabama,1059,Franklin County,10417,1568,12077,8849,0.862548646,0.129833568,0.732715078
Alabama,1061,Geneva County,10929,1391,12390,9538,0.882082324,0.112267958,0.769814366
Alabama,1063,Greene County,885,3133,4035,-2248,0.219330855,0.77645601,-0.557125155
Alabama,1065,Hale County,3369,3868,7290,-499,0.462139918,0.530589849,-0.068449931
Alabama,1067,Henry County,6989,2263,9301,4726,0.751424578,0.243307171,0.508117407
Alabama,1069,Houston County,32469,11352,44195,21117,0.734675868,0.256861636,0.477814232
Alabama,1071,Jackson County,20073,3276,23509,16797,0.853843209,0.139350887,0.714492322
Alabama,1073,Jefferson County,131123,162112,296741,-30989,0.441876923,0.54630806,-0.104431137
Alabama,1075,Lamar County,6033,806,6875,5227,0.877527273,0.117236364,0.760290909
Alabama,1077,Lauderdale County,32708,10326,43454,22382,0.752704009,0.237630598,0.515073411
Alabama,1079,Lawrence County,13024,2983,16115,10041,0.808191126,0.185107043,0.623084083
Alabama,1081,Lee County,46020,25798,72695,20222,0.633055919,0.354879978,0.278175941
Alabama,1083,Limestone County,37887,14581,53096,23306,0.713556577,0.27461579,0.438940786
Alabama,1085,Lowndes County,1758,3867,5652,-2109,0.31104034,0.68418259,-0.373142251
Alabama,1087,Macon County,1682,6084,7820,-4402,0.215089514,0.778005115,-0.562915601
Alabama,1089,Madison County,105430,87824,196355,17606,0.536935652,0.447271524,0.089664129
Alabama,1091,Marengo County,4995,4631,9673,364,0.516385816,0.478755298,0.037630518
Alabama,1093,Marion County,12245,1197,13523,11048,0.905494343,0.088515862,0.816978481
Alabama,1095,Marshall County,34434,5553,40277,28881,0.854929612,0.137870249,0.717059364
Alabama,1097,Mobile County,100759,72055,174545,28704,0.577266607,0.412816179,0.164450428
Alabama,1099,Monroe County,6007,3740,9799,2267,0.613021737,0.381671599,0.231350138
Alabama,1101,Montgomery County,30477,57946,89375,-27469,0.341001399,0.648346853,-0.307345455
Alabama,1103,Morgan County,40449,12392,53369,28057,0.757911896,0.23219472,0.525717177
Alabama,1105,Perry County,1269,3174,4457,-1905,0.284720664,0.71213821,-0.427417545
Alabama,1107,Pickens County,5465,3388,8898,2077,0.614182962,0.380759721,0.233423241
Alabama,1109,Pike County,8224,4899,13214,3325,0.622370213,0.370743151,0.251627062
Alabama,1111,Randolph County,9102,1920,11075,7182,0.821851016,0.173363431,0.648487585
Alabama,1113,Russell County,10078,10422,20679,-344,0.487354321,0.503989555,-0.016635234
Alabama,1115,St. Clair County,35501,7640,43440,27861,0.817242173,0.17587477,0.641367403
Alabama,1117,Shelby County,79666,33087,114043,46579,0.698561069,0.290127408,0.408433661
Alabama,1119,Sumter County,1542,3725,5297,-2183,0.291108174,0.703228242,-0.412120068
Alabama,1121,Talladega County,22100,10898,33175,11202,0.66616428,0.328500377,0.337663904
Alabama,1123,Tallapoosa County,14884,4975,19980,9909,0.744944945,0.248998999,0.495945946
Alabama,1125,Tuscaloosa County,50724,33399,84879,17325,0.597603648,0.393489556,0.204114092
Alabama,1127,Walker County,25464,4102,29747,21362,0.856019094,0.137896258,0.718122836
Alabama,1129,Washington County,6534,1863,8430,4671,0.775088968,0.220996441,0.554092527
Alabama,1131,Wilcox County,1793,3449,5260,-1656,0.340874525,0.655703422,-0.314828897
Alabama,1133,Winston County,10191,884,11129,9307,0.915715698,0.079432114,0.836283583
Alaska,2001,State House District 1,4861,3367,8228,1494,0.590787555,0.409212445,0.181575109
Alaska,2002,State House District 2,4534,4571,9105,-37,0.497968149,0.502031851,-0.004063701
Alaska,2003,State House District 3,4496,6130,10626,-1634,0.423113119,0.576886881,-0.153773762
Alaska,2004,State House District 4,2691,6161,8852,-3470,0.303999096,0.696000904,-0.392001808
Alaska,2005,State House District 5,4351,3328,7679,1023,0.566610236,0.433389764,0.133220471
Alaska,2006,State House District 6,6705,4773,11478,1932,0.584161004,0.415838996,0.168322007
Alaska,2007,State House District 7,6777,2513,9290,4264,0.72949408,0.27050592,0.458988159
Alaska,2008,State House District 8,7950,2576,10526,5374,0.755272658,0.244727342,0.510545316
Alaska,2009,State House District 9,5581,5849,11430,-268,0.488276465,0.511723535,-0.023447069
Alaska,2010,State House District 10,4357,4070,8427,287,0.517028599,0.482971401,0.034057197
Alaska,2011,State House District 11,4864,4633,9497,231,0.512161735,0.487838265,0.024323471
Alaska,2012,State House District 12,4059,4169,8228,-110,0.493315508,0.506684492,-0.013368984
Alaska,2013,State House District 13,3589,3682,7271,-93,0.493604731,0.506395269,-0.012790538
Alaska,2014,State House District 14,2768,4346,7114,-1578,0.389091931,0.610908069,-0.221816137
Alaska,2015,State House District 15,4594,4364,8958,230,0.512837687,0.487162313,0.025675374
Alaska,2016,State House District 16,3929,5344,9273,-1415,0.423703224,0.576296776,-0.152593551
Alaska,2017,State House District 17,2407,4990,7397,-2583,0.32540219,0.67459781,-0.34919562
Alaska,2018,State House District 18,2686,1928,4614,758,0.582141309,0.417858691,0.164282618
Alaska,2019,State House District 19,1971,2825,4796,-854,0.410967473,0.589032527,-0.178065054
Alaska,2020,State House District 20,3041,3924,6965,-883,0.43661163,0.56338837,-0.126776741
Alaska,2021,State House District 21,3984,4711,8695,-727,0.458194365,0.541805635,-0.083611271
Alaska,2022,State House District 22,2594,2660,5254,-66,0.493719071,0.506280929,-0.012561858
Alaska,2023,State House District 23,6101,4116,10217,1985,0.597142018,0.402857982,0.194284036
Alaska,2024,State House District 24,6482,3234,9716,3248,0.667146974,0.332853026,0.334293948
Alaska,2025,State House District 25,6891,3172,10063,3719,0.684785849,0.315214151,0.369571698
Alaska,2026,State House District 26,7143,2013,9156,5130,0.780144168,0.219855832,0.560288336
Alaska,2027,State House District 27,6785,1807,8592,4978,0.789688082,0.210311918,0.579376164
Alaska,2028,State House District 28,6713,2213,8926,4500,0.752072597,0.247927403,0.504145194
Alaska,2029,State House District 29,7418,2708,10126,4710,0.732569623,0.267430377,0.465139246
Alaska,2030,State House District 30,7312,2701,10013,4611,0.730250674,0.269749326,0.460501348
Alaska,2031,State House District 31,3475,3240,6715,235,0.517498138,0.482501862,0.034996277
Alaska,2032,State House District 32,3742,1883,5625,1859,0.665244444,0.334755556,0.330488889
Alaska,2033,State House District 33,6548,2016,8564,4532,0.764595983,0.235404017,0.529191966
Alaska,2034,State House District 34,5836,3759,9595,2077,0.608233455,0.391766545,0.21646691
Alaska,2035,State House District 35,4395,4885,9280,-490,0.473599138,0.526400862,-0.052801724
Alaska,2036,State House District 36,5633,3538,9171,2095,0.614218733,0.385781267,0.228437466
Alaska,2037,State House District 37,2208,1921,4129,287,0.534754178,0.465245822,0.069508356
Alaska,2038,State House District 38,1558,2028,3586,-470,0.434467373,0.565532627,-0.131065254
Alaska,2039,State House District 39,1690,2180,3870,-490,0.436692506,0.563307494,-0.126614987
Alaska,2040,State House District 40,1688,1362,3050,326,0.553442623,0.446557377,0.106885246
Arizona,4001,Apache County,12795,18872,32019,-6077,0.399606484,0.589400044,-0.18979356
Arizona,4003,Cochise County,35936,22296,58923,13640,0.609880692,0.378392139,0.231488553
Arizona,4005,Coconino County,27576,41504,70067,-13928,0.393566158,0.592347325,-0.198781167
Arizona,4007,Gila County,18901,8504,27648,10397,0.683629919,0.307581019,0.3760489
Arizona,4009,Graham County,11177,3867,15183,7310,0.736152276,0.254692748,0.481459527
Arizona,4011,Greenlee County,2308,954,3308,1354,0.697702539,0.288391778,0.409310762
Arizona,4012,La Paz County,5470,2101,7624,3369,0.717471144,0.275577125,0.441894019
Arizona,4013,Maricopa County,1051531,980016,2053945,71515,0.511956747,0.477138385,0.034818362
Arizona,4015,Mohave County,85683,24081,110450,61602,0.775762789,0.218026256,0.557736532
Arizona,4017,Navajo County,29480,20754,50706,8726,0.581390762,0.409300674,0.172090088
Arizona,4019,Pima County,214669,292450,513176,-77781,0.418314574,0.569882457,-0.151567883
Arizona,4021,Pinal County,126926,80656,209552,46270,0.605701687,0.384897305,0.220804383
Arizona,4023,Santa Cruz County,7699,11265,19121,-3566,0.402646305,0.589142827,-0.186496522
Arizona,4025,Yavapai County,99346,48717,149402,50629,0.664957631,0.326079972,0.338877659
Arizona,4027,Yuma County,40745,26823,68195,13922,0.597477821,0.393327957,0.204149864
Arkansas,5001,Arkansas County,3951,1503,5547,2448,0.712276906,0.270957274,0.441319632
Arkansas,5003,Ashley County,5145,1774,7030,3371,0.731863442,0.252347084,0.479516358
Arkansas,5005,Baxter County,16253,4341,20954,11912,0.775651427,0.207168082,0.568483344
Arkansas,5007,Benton County,79907,45231,128595,34676,0.621384968,0.351732182,0.269652786
Arkansas,5009,Boone County,13968,2854,17112,11114,0.816269285,0.166783544,0.649485741
Arkansas,5011,Bradley County,2213,961,3209,1252,0.689622935,0.29947024,0.390152696
Arkansas,5013,Calhoun County,1674,379,2092,1295,0.800191205,0.181166348,0.619024857
Arkansas,5015,Carroll County,7470,3812,11538,3658,0.647425897,0.330386549,0.317039348
Arkansas,5017,Chicot County,1658,1796,3490,-138,0.475071633,0.514613181,-0.039541547
Arkansas,5019,Clark County,4526,2959,7657,1567,0.591093117,0.386443777,0.20464934
Arkansas,5021,Clay County,3968,907,4967,3061,0.798872559,0.182605194,0.616267365
Arkansas,5023,Cleburne County,10595,1941,12739,8654,0.831697935,0.152366748,0.679331188
Arkansas,5025,Cleveland County,2804,524,3374,2280,0.831061055,0.155305276,0.675755779
Arkansas,5027,Columbia County,5367,2466,7940,2901,0.675944584,0.310579345,0.365365239
Arkansas,5029,Conway County,5893,2449,8541,3444,0.689966046,0.286734574,0.403231472
Arkansas,5031,Craighead County,25152,11210,37242,13942,0.675366522,0.301004243,0.374362279
Arkansas,5033,Crawford County,18615,4753,23834,13862,0.781027104,0.199420995,0.581606109
Arkansas,5035,Crittenden County,7028,7362,14681,-334,0.478713984,0.501464478,-0.022750494
Arkansas,5037,Cross County,4753,1642,6534,3111,0.727425773,0.251300888,0.476124885
Arkansas,5039,Dallas County,1482,798,2324,684,0.637693632,0.343373494,0.294320138
Arkansas,5041,Desha County,1805,1638,3505,167,0.514978602,0.467332382,0.04764622
Arkansas,5043,Drew County,4203,2050,6365,2153,0.660329929,0.322073841,0.338256088
Arkansas,5045,Faulkner County,35357,17752,54465,17605,0.649169191,0.325934086,0.323235105
Arkansas,5047,Franklin County,5582,1232,6971,4350,0.800745947,0.176732176,0.624013771
Arkansas,5049,Fulton County,4040,906,5043,3134,0.80111045,0.179654967,0.621455483
Arkansas,5051,Garland County,28359,13015,42327,15344,0.669997874,0.307486947,0.362510927
Arkansas,5053,Grant County,6755,1192,8078,5563,0.836221837,0.147561278,0.68866056
Arkansas,5055,Greene County,12617,2935,15820,9682,0.797534766,0.185524652,0.612010114
Arkansas,5057,Hempstead County,4193,1776,6089,2417,0.688618821,0.29167351,0.396945311
Arkansas,5059,Hot Spring County,9226,2818,12283,6408,0.751119433,0.229422779,0.521696654
Arkansas,5061,Howard County,3246,1158,4473,2088,0.725687458,0.258886653,0.466800805
Arkansas,5063,Independence County,11023,2689,14011,8334,0.786738991,0.191920634,0.594818357
Arkansas,5065,Izard County,4854,949,5925,3905,0.819240506,0.160168776,0.65907173
Arkansas,5067,Jackson County,3509,1183,4775,2326,0.73486911,0.247748691,0.487120419
Arkansas,5069,Jefferson County,8468,12802,21608,-4334,0.391891892,0.592465753,-0.200573862
Arkansas,5071,Johnson County,6766,2107,9059,4659,0.746881554,0.232586378,0.514295176
Arkansas,5073,Lafayette County,1589,698,2325,891,0.68344086,0.300215054,0.383225806
Arkansas,5075,Lawrence County,4608,965,5692,3643,0.809557273,0.169536191,0.640021082
Arkansas,5077,Lee County,1181,1270,2520,-89,0.468650794,0.503968254,-0.03531746
Arkansas,5079,Lincoln County,2502,813,3372,1689,0.741992883,0.241103203,0.50088968
Arkansas,5081,Little River County,3744,1084,4899,2660,0.7642376,0.221269647,0.542967953
Arkansas,5083,Logan County,6567,1464,8205,5103,0.800365631,0.178427788,0.621937843
Arkansas,5085,Lonoke County,23225,6790,30620,16435,0.758491182,0.22175049,0.536740692
Arkansas,5087,Madison County,5885,1491,7501,4394,0.784562058,0.198773497,0.585788562
Arkansas,5089,Marion County,6230,1501,7851,4729,0.793529487,0.191185836,0.60234365
Arkansas,5091,Miller County,11842,3769,15803,8073,0.749351389,0.238499019,0.51085237
Arkansas,5093,Mississippi County,6963,3574,10717,3389,0.649715405,0.333488849,0.316226556
Arkansas,5095,Monroe County,1385,1002,2433,383,0.569256062,0.411837238,0.157418824
Arkansas,5097,Montgomery County,2987,645,3707,2342,0.805772862,0.173995144,0.631777718
Arkansas,5099,Nevada County,2002,849,2907,1153,0.688682491,0.292053664,0.396628827
Arkansas,5101,Newton County,3063,644,3770,2419,0.812466844,0.170822281,0.641644562
Arkansas,5103,Ouachita County,5056,3412,8626,1644,0.586134941,0.395548342,0.190586599
Arkansas,5105,Perry County,3559,923,4584,2636,0.776396161,0.201352531,0.57504363
Arkansas,5107,Phillips County,2098,2754,4938,-656,0.424868368,0.557715674,-0.132847307
Arkansas,5109,Pike County,3746,560,4358,3186,0.859568609,0.128499312,0.731069298
Arkansas,5111,Poinsett County,5731,1235,7079,4496,0.809577624,0.174459669,0.635117955
Arkansas,5113,Polk County,6987,1145,8288,5842,0.843026062,0.138151544,0.704874517
Arkansas,5115,Pope County,18118,5487,24191,12631,0.748956223,0.226819892,0.522136332
Arkansas,5117,Prairie County,2628,524,3200,2104,0.82125,0.16375,0.6575
Arkansas,5119,Pulaski County,57977,92038,153924,-34061,0.37665991,0.59794444,-0.22128453
Arkansas,5121,Randolph County,5367,1138,6636,4229,0.808770344,0.171488849,0.637281495
Arkansas,5123,St. Francis County,2909,2953,5979,-44,0.48653621,0.4938953,-0.00735909
Arkansas,5125,Saline County,39736,16609,57609,23127,0.689753337,0.288305647,0.40144769
Arkansas,5127,Scott County,2913,425,3384,2488,0.860815603,0.125591017,0.735224586
Arkansas,5129,Searcy County,3305,511,3869,2794,0.854225898,0.132075472,0.722150426
Arkansas,5131,Sebastian County,30719,13652,45452,17067,0.675855848,0.30036082,0.375495028
Arkansas,5133,Sevier County,3772,862,4714,2910,0.800169707,0.182859567,0.61731014
Arkansas,5135,Sharp County,5978,1316,7437,4662,0.803818744,0.176953072,0.626865672
Arkansas,5137,Stone County,4808,1089,6030,3719,0.7973466,0.180597015,0.616749585
Arkansas,5139,Union County,10196,5019,15448,5177,0.660020715,0.324896427,0.335124288
Arkansas,5141,Van Buren County,6023,1437,7621,4586,0.790316231,0.188557932,0.601758299
Arkansas,5143,Washington County,50243,43779,97158,6464,0.517126742,0.450595937,0.066530805
Arkansas,5145,White County,24514,5641,30837,18873,0.794954114,0.182929598,0.612024516
Arkansas,5147,Woodruff County,1513,760,2318,753,0.65271786,0.327868852,0.324849008
Arkansas,5149,Yell County,5147,1213,6477,3934,0.794658021,0.187278061,0.60737996
California,6001,Alameda County,140789,499551,669800,-358762,0.210195581,0.745821141,-0.53562556
California,6003,Alpine County,243,479,738,-236,0.329268293,0.649051491,-0.319783198
California,6005,Amador County,14018,7783,22402,6235,0.625747701,0.347424337,0.278323364
California,6007,Butte County,47179,44228,94523,2951,0.499127197,0.467907282,0.031219915
California,6009,Calaveras County,16625,9181,26479,7444,0.627856037,0.346727595,0.281128441
California,6011,Colusa County,4414,2431,7021,1983,0.628685372,0.346246973,0.282438399
California,6013,Contra Costa County,155308,356008,528904,-200700,0.29364119,0.673105138,-0.379463948
California,6015,Del Norte County,5999,4266,10564,1733,0.567872018,0.403824309,0.164047709
California,6017,El Dorado County,61109,47703,111890,13406,0.546152471,0.426338368,0.119814103
California,6019,Fresno County,165924,151628,325994,14296,0.508978693,0.465125125,0.043853568
California,6021,Glenn County,6904,3260,10442,3644,0.66117602,0.312200728,0.348975292
California,6023,Humboldt County,21559,39800,64228,-18241,0.335663574,0.619667435,-0.284003861
California,6025,Imperial County,26546,26083,54025,463,0.491365109,0.482795002,0.008570106
California,6027,Inyo County,4468,4201,8951,267,0.499162105,0.469333035,0.029829069
California,6029,Kern County,167879,108241,283246,59638,0.592696808,0.382144849,0.210551958
California,6031,Kings County,25074,15519,41501,9555,0.604178213,0.373942797,0.230235416
California,6033,Lake County,13161,12794,26759,367,0.491834523,0.478119511,0.013715012
California,6035,Lassen County,8619,2478,11371,6141,0.757980828,0.217922786,0.540058042
California,6037,Los Angeles County,1189862,2417109,3728427,-1227247,0.319132438,0.648291894,-0.329159455
California,6039,Madera County,32344,20981,54624,11363,0.59212068,0.384098565,0.208022115
California,6041,Marin County,24054,116152,144113,-92098,0.166910688,0.805978642,-0.639067954
California,6043,Mariposa County,5625,3622,9509,2003,0.591544852,0.380902303,0.210642549
California,6045,Mendocino County,13528,24049,39216,-10521,0.34496124,0.613244594,-0.268283354
California,6047,Merced County,43955,40190,86392,3765,0.508785536,0.465205112,0.043580424
California,6049,Modoc County,2884,1008,4016,1876,0.71812749,0.250996016,0.467131474
California,6051,Mono County,2294,3522,6064,-1228,0.378298153,0.580804749,-0.202506596
California,6053,Monterey County,49226,93060,146718,-43834,0.335514388,0.634278003,-0.298763615
California,6055,Napa County,20357,43212,65549,-22855,0.310561565,0.659232025,-0.34867046
California,6057,Nevada County,26177,33784,62132,-7607,0.421312689,0.543745574,-0.122432885
California,6059,Orange County,654815,691731,1390965,-36916,0.470763103,0.497302952,-0.026539848
California,6061,Placer County,123941,103958,234809,19983,0.527837519,0.442734307,0.085103212
California,6063,Plumas County,5725,4020,10067,1705,0.568689778,0.399324526,0.169365253
California,6065,Riverside County,463677,451782,940405,11895,0.493060968,0.480412163,0.012648806
California,6067,Sacramento County,252140,381564,656626,-129424,0.383993323,0.581097916,-0.197104592
California,6069,San Benito County,11702,15179,27649,-3477,0.423234113,0.548989114,-0.125755
California,6071,San Bernardino County,378416,362114,761714,16302,0.496795385,0.475393652,0.021401733
California,6073,San Diego County,593270,841372,1477786,-248102,0.401458669,0.569346306,-0.167887637
California,6075,San Francisco County,62594,323719,402964,-261125,0.155333975,0.803344716,-0.64801074
California,6077,San Joaquin County,128996,126647,263671,2349,0.489230898,0.480322068,0.00890883
California,6079,San Luis Obispo County,64932,81314,150766,-16382,0.430680657,0.539339108,-0.108658451
California,6081,San Mateo County,76616,242957,330510,-166341,0.231811443,0.735097274,-0.503285831
California,6083,Santa Barbara County,64870,114149,184715,-49279,0.351189671,0.617973635,-0.266783964
California,6085,Santa Clara County,210924,510744,750433,-299820,0.281069729,0.680599067,-0.399529338
California,6087,Santa Cruz County,27978,100998,134135,-73020,0.208580907,0.752957841,-0.544376934
California,6089,Shasta County,59539,27130,88900,32409,0.669730034,0.305174353,0.364555681
California,6091,Sierra County,1066,641,1754,425,0.607753706,0.365450399,0.242303307
California,6093,Siskiyou County,12461,8329,21489,4132,0.579878077,0.387593653,0.192284425
California,6095,Solano County,70345,113997,189834,-43652,0.370560595,0.600508866,-0.229948271
California,6097,Sonoma County,63426,179600,251426,-116174,0.25226508,0.714325487,-0.462060407
California,6099,Stanislaus County,106986,85347,197472,21639,0.541778075,0.432197982,0.109580092
California,6101,Sutter County,25372,13016,39336,12356,0.645007118,0.330892821,0.314114297
California,6103,Tehama County,18503,7415,26532,11088,0.697384291,0.279473843,0.417910448
California,6105,Trinity County,2979,2449,5645,530,0.527723649,0.433835252,0.093888397
California,6107,Tulare County,81854,53221,138271,28633,0.591982411,0.384903559,0.207078852
California,6109,Tuolumne County,17210,10909,28810,6301,0.597362027,0.378653245,0.218708782
California,6111,Ventura County,158901,217424,387595,-58523,0.409966589,0.560956669,-0.15099008
California,6113,Yolo County,27844,61405,92589,-33561,0.300726868,0.663199732,-0.362472864
California,6115,Yuba County,18491,10725,30070,7766,0.614931826,0.356667775,0.258264051
Colorado,8001,Adams County,103024,124056,233336,-21032,0.441526383,0.531662495,-0.090136113
Colorado,8003,Alamosa County,4057,3244,7519,813,0.539566432,0.431440351,0.108126081
Colorado,8005,Arapahoe County,125311,190725,325451,-65414,0.385037993,0.58603292,-0.200994927
Colorado,8007,Archuleta County,5218,3904,9355,1314,0.55777659,0.417316943,0.140459647
Colorado,8009,Baca County,1686,275,2004,1411,0.841317365,0.137225549,0.704091816
Colorado,8011,Bent County,1496,645,2189,851,0.683417085,0.294655094,0.388761992
Colorado,8013,Boulder County,40758,150149,196150,-109391,0.207789957,0.7654805,-0.557690543
Colorado,8014,Broomfield County,16071,29426,46817,-13355,0.343272743,0.628532371,-0.285259628
Colorado,8015,Chaffee County,6034,7992,14416,-1958,0.418562708,0.554384018,-0.13582131
Colorado,8017,Cheyenne County,930,108,1055,822,0.881516588,0.102369668,0.779146919
Colorado,8019,Clear Creek County,2452,3464,6101,-1012,0.401901328,0.567775774,-0.165874447
Colorado,8021,Conejos County,2358,1627,4104,731,0.574561404,0.396442495,0.178118908
Colorado,8023,Costilla County,850,1155,2080,-305,0.408653846,0.555288462,-0.146634615
Colorado,8025,Crowley County,1231,422,1706,809,0.721570926,0.247362251,0.474208675
Colorado,8027,Custer County,2583,1188,3867,1395,0.667959659,0.307214895,0.360744763
Colorado,8029,Delta County,12948,6030,19476,6918,0.664818238,0.30961183,0.355206408
Colorado,8031,Denver County,74765,278634,363076,-203869,0.205921074,0.767426104,-0.561505029
Colorado,8033,Dolores County,1076,325,1419,751,0.758280479,0.229034531,0.529245948
Colorado,8035,Douglas County,127451,110408,243758,17043,0.522858737,0.452941032,0.069917705
Colorado,8037,Eagle County,10148,16943,27798,-6795,0.365062235,0.609504281,-0.244442046
Colorado,8039,Elbert County,15209,4768,20417,10441,0.74491845,0.233530881,0.511387569
Colorado,8041,El Paso County,203933,166597,380813,37336,0.535520058,0.437477187,0.098042871
Colorado,8043,Fremont County,17313,7526,25467,9787,0.679820945,0.295519692,0.384301253
Colorado,8045,Garfield County,14493,15128,30372,-635,0.477182932,0.498090346,-0.020907415
Colorado,8047,Gilpin County,1729,2254,4129,-525,0.418745459,0.54589489,-0.127149431
Colorado,8049,Grand County,4822,4743,9883,79,0.48790853,0.479915006,0.007993524
Colorado,8051,Gunnison County,3689,6887,10939,-3198,0.337233751,0.629582229,-0.292348478
Colorado,8053,Hinsdale County,332,257,606,75,0.547854785,0.424092409,0.123762376
Colorado,8055,Huerfano County,2346,1965,4438,381,0.528616494,0.442767012,0.085849482
Colorado,8057,Jackson County,634,173,834,461,0.760191847,0.207434053,0.552757794
Colorado,8059,Jefferson County,140505,210875,361504,-70370,0.388667899,0.583326879,-0.19465898
Colorado,8061,Kiowa County,744,102,863,642,0.862108922,0.118192352,0.74391657
Colorado,8063,Kit Carson County,3083,556,3698,2527,0.833693889,0.150351541,0.683342347
Colorado,8065,Lake County,1557,2199,3911,-642,0.398107901,0.562260291,-0.164152391
Colorado,8067,La Plata County,14024,20677,35681,-6653,0.393038312,0.57949609,-0.186457779
Colorado,8069,Larimer County,89680,129376,225482,-39696,0.397725761,0.57377529,-0.176049529
Colorado,8071,Las Animas County,4328,3276,7792,1052,0.555441478,0.420431211,0.135010267
Colorado,8073,Lincoln County,2090,432,2571,1658,0.812913263,0.168028005,0.644885259
Colorado,8075,Logan County,7855,2098,10162,5757,0.77297776,0.206455422,0.566522338
Colorado,8077,Mesa County,55839,33573,91600,22266,0.60959607,0.366517467,0.243078603
Colorado,8079,Mineral County,417,317,753,100,0.553784861,0.420982736,0.132802125
Colorado,8081,Moffat County,5358,1167,6671,4191,0.803177934,0.174936291,0.628241643
Colorado,8083,Montezuma County,8972,5793,15136,3179,0.592758985,0.382729915,0.21002907
Colorado,8085,Montrose County,16704,8354,25617,8350,0.652066987,0.326111567,0.32595542
Colorado,8087,Morgan County,9830,3291,13458,6539,0.730420568,0.244538564,0.485882003
Colorado,8089,Otero County,5520,3164,8925,2356,0.618487395,0.354509804,0.263977591
Colorado,8091,Ouray County,1573,2442,4098,-869,0.383845778,0.595900439,-0.212054661
Colorado,8093,Park County,6828,4841,12044,1987,0.566921289,0.401942876,0.164978412
Colorado,8095,Phillips County,1888,412,2354,1476,0.802039082,0.17502124,0.627017842
Colorado,8097,Pitkin County,2992,7932,11167,-4940,0.267932301,0.710307155,-0.442374854
Colorado,8099,Prowers County,3833,1227,5144,2606,0.745139969,0.238530327,0.506609642
Colorado,8101,Pueblo County,43688,39328,85107,4360,0.513330278,0.46210065,0.051229629
Colorado,8103,Rio Blanco County,2988,637,3690,2351,0.809756098,0.172628726,0.637127371
Colorado,8105,Rio Grande County,3743,2306,6194,1437,0.604294479,0.37229577,0.231998708
Colorado,8107,Routt County,5676,10208,16335,-4532,0.347474747,0.624915825,-0.277441077
Colorado,8109,Saguache County,1577,1704,3400,-127,0.463823529,0.501176471,-0.037352941
Colorado,8111,San Juan County,188,376,588,-188,0.319727891,0.639455782,-0.319727891
Colorado,8113,San Miguel County,1154,3529,4804,-2375,0.240216486,0.73459617,-0.494379684
Colorado,8115,Sedgwick County,1048,283,1358,765,0.771723122,0.208394698,0.563328424
Colorado,8117,Summit County,5244,11762,17542,-6518,0.298939688,0.670505074,-0.371565386
Colorado,8119,Teller County,10856,5065,16326,5791,0.664951611,0.310241333,0.354710278
Colorado,8121,Washington County,2436,329,2806,2107,0.868139701,0.117248753,0.750890948
Colorado,8123,Weld County,106469,68752,179854,37717,0.591974602,0.382265615,0.209708986
Colorado,8125,Yuma County,3807,758,4663,3049,0.816427193,0.162556294,0.653870899
Connecticut,9110,Capitol Planning Region,181038,285105,474268,-104067,0.381720884,0.601147452,-0.219426569
Connecticut,9120,Greater Bridgeport Planning Region,51519,83461,137015,-31942,0.376009926,0.609137686,-0.23312776
Connecticut,9130,Lower Connecticut River Valley Planning Region,44318,58360,104480,-14042,0.424176876,0.558575804,-0.134398928
Connecticut,9140,Naugatuck Valley Planning Region,115290,99237,217520,16053,0.530020228,0.456220118,0.07380011
Connecticut,9150,Northeastern Connecticut Planning Region,29028,21165,50962,7863,0.569600879,0.415309446,0.154291433
Connecticut,9160,Northwest Hills Planning Region,31944,31137,64076,807,0.498532992,0.485938573,0.012594419
Connecticut,9170,South Central Connecticut Planning Region,103087,156248,264854,-53161,0.389221986,0.589940118,-0.200718131
Connecticut,9180,Southeastern Connecticut Planning Region,58392,76146,136954,-17754,0.426362136,0.555996904,-0.129634768
Connecticut,9190,Western Connecticut Planning Region,122302,181194,308300,-58892,0.396698021,0.587719753,-0.191021732
Delaware,10001,Kent County,42458,44222,88141,-1764,0.481705449,0.501718837,-0.020013388
Delaware,10003,New Castle County,90868,180700,275917,-89832,0.329330922,0.654907092,-0.32557617
Delaware,10005,Sussex County,81025,64836,147639,16189,0.548804855,0.439152257,0.109652599
District of Columbia,11001,Ward 1,2056,36882,40463,-34826,0.050811853,0.911499395,-0.860687542
District of Columbia,11002,Ward 2,2982,33571,37959,-30589,0.078558445,0.884401591,-0.805843147
District of Columbia,11003,Ward 3,3544,39521,44584,-35977,0.0794904,0.886439081,-0.806948681
District of Columbia,11004,Ward 4,2511,38628,42403,-36117,0.059217508,0.91097328,-0.851755772
District of Columbia,11005,Ward 5,2309,41413,45114,-39104,0.051181451,0.917963382,-0.86678193
District of Columbia,11006,Ward 6,3638,43262,48678,-39624,0.07473602,0.888738239,-0.814002219
District of Columbia,11007,Ward 7,2092,33972,37037,-31880,0.056484056,0.917244917,-0.860760861
District of Columbia,11008,Ward 8,1944,26936,29631,-24992,0.065606966,0.909047957,-0.843440991
Florida,12001,Alachua County,52939,81578,136548,-28639,0.387695169,0.59743094,-0.209735771
Florida,12003,Baker County,12926,1982,14977,10944,0.863056687,0.132336249,0.730720438
Florida,12005,Bay County,71497,25201,97775,46296,0.731240092,0.257744822,0.47349527
Florida,12007,Bradford County,10920,2946,13932,7974,0.783807063,0.211455642,0.572351421
Florida,12009,Brevard County,216533,141233,361449,75300,0.599069302,0.390741156,0.208328146
Florida,12011,Broward County,358952,507328,874526,-148376,0.410453206,0.580117687,-0.169664481
Florida,12013,Calhoun County,5367,1021,6428,4346,0.834940884,0.158836341,0.676104543
Florida,12015,Charlotte County,82480,40450,123674,42030,0.66691463,0.327069554,0.339845077
Florida,12017,Citrus County,71356,26276,98233,45080,0.726395407,0.267486486,0.458908921
Florida,12019,Clay County,87711,37926,126806,49785,0.691694399,0.299086794,0.392607605
Florida,12021,Collier County,143267,71720,216363,71547,0.662160351,0.331479967,0.330680384
Florida,12023,Columbia County,25108,8250,33592,16858,0.747439867,0.245594189,0.501845678
Florida,12027,DeSoto County,8888,3525,12488,5363,0.711723254,0.28227098,0.429452274
Florida,12029,Dixie County,6920,1183,8148,5737,0.849288169,0.145189003,0.704099165
Florida,12031,Duval County,236285,229365,471268,6920,0.50138138,0.48669759,0.014683789
Florida,12033,Escambia County,96407,64601,162754,31806,0.592347961,0.396924192,0.195423768
Florida,12035,Flagler County,51014,28431,79963,22583,0.637970061,0.355551943,0.282418118
Florida,12037,Franklin County,4831,1870,6758,2961,0.714856466,0.276709086,0.438147381
Florida,12039,Gadsden County,7495,14203,21868,-6708,0.342738248,0.649487836,-0.306749588
Florida,12041,Gilchrist County,8931,1662,10686,7269,0.835766423,0.155530601,0.680235823
Florida,12043,Glades County,4034,1222,5279,2812,0.764159879,0.231483235,0.532676643
Florida,12045,Gulf County,6684,1970,8697,4714,0.768540876,0.22651489,0.542025986
Florida,12047,Hamilton County,3964,1727,5733,2237,0.691435549,0.301238444,0.390197104
Florida,12049,Hardee County,6336,1751,8143,4585,0.778091612,0.215031315,0.563060297
Florida,12051,Hendry County,9253,4096,13460,5157,0.687444279,0.304309064,0.383135215
Florida,12053,Hernando County,75446,34431,110687,41015,0.681615727,0.31106634,0.370549387
Florida,12055,Highlands County,36382,15227,51905,21155,0.700934399,0.293362874,0.407571525
Florida,12057,Hillsborough County,342017,321455,671981,20562,0.50896826,0.47836918,0.030599079
Florida,12059,Holmes County,8193,882,9116,7311,0.898749452,0.096752962,0.80199649
Florida,12061,Indian River County,62737,35654,99015,27083,0.633611069,0.360086856,0.273524214
Florida,12063,Jackson County,16074,5892,22098,10182,0.727396144,0.266630464,0.46076568
Florida,12065,Jefferson County,5011,3429,8502,1582,0.589390732,0.403316867,0.186073865
Florida,12067,Lafayette County,3296,441,3756,2855,0.877529286,0.117412141,0.760117146
Florida,12069,Lake County,140500,84546,226781,55954,0.619540438,0.37280901,0.246731428
Florida,12071,Lee County,250661,139240,392519,111421,0.638595839,0.35473442,0.283861418
Florida,12073,Leon County,60397,94520,156800,-34123,0.385184949,0.602806122,-0.217621173
Florida,12075,Levy County,18245,5994,24377,12251,0.748451409,0.245887517,0.502563892
Florida,12077,Liberty County,2898,566,3490,2332,0.830372493,0.16217765,0.668194842
Florida,12079,Madison County,5874,3231,9156,2643,0.641546527,0.352883355,0.288663172
Florida,12081,Manatee County,140486,86674,228856,53812,0.613861992,0.378727235,0.235134757
Florida,12083,Marion County,140173,72436,214101,67737,0.654705022,0.338326304,0.316378718
Florida,12085,Martin County,64121,33539,98291,30582,0.652358812,0.341221475,0.311137337
Florida,12086,Miami-Dade County,605590,480355,1094093,125235,0.553508705,0.43904403,0.114464675
Florida,12087,Monroe County,26064,17933,44327,8131,0.587993774,0.404561554,0.18343222
Florida,12089,Nassau County,47945,17143,65621,30802,0.73063501,0.26124259,0.46939242
Florida,12091,Okaloosa County,80309,32074,113634,48235,0.7067339,0.282257071,0.424476829
Florida,12093,Okeechobee County,12315,3671,16058,8644,0.76690746,0.228608793,0.538298667
Florida,12095,Orange County,258279,340807,607191,-82528,0.425366977,0.56128467,-0.135917693
Florida,12097,Osceola County,86713,84205,172776,2508,0.501881048,0.487365143,0.014515905
Florida,12099,Palm Beach County,366836,372512,745697,-5676,0.491937074,0.499548744,-0.007611671
Florida,12101,Pasco County,197779,117450,318463,80329,0.621042319,0.368802655,0.252239664
Florida,12103,Pinellas County,269472,242452,517058,27020,0.52116397,0.468906776,0.052257194
Florida,12105,Polk County,209044,136879,348922,72165,0.599113842,0.392291114,0.206822728
Florida,12107,Putnam County,26700,9354,36272,17346,0.736104985,0.25788487,0.478220115
Florida,12109,St. Johns County,128759,66862,197452,61897,0.65210279,0.338624071,0.313478719
Florida,12111,St. Lucie County,100293,83517,185131,16776,0.541740713,0.451123799,0.090616915
Florida,12113,Santa Rosa County,84314,27035,112424,57279,0.74996442,0.240473564,0.509490856
Florida,12115,Sarasota County,163219,112668,277857,50551,0.587420868,0.405489154,0.181931713
Florida,12117,Seminole County,129735,120717,253720,9018,0.511331389,0.475788271,0.035543118
Florida,12119,Sumter County,72134,32551,105217,39583,0.685573624,0.309370159,0.376203465
Florida,12121,Suwannee County,17561,4217,21891,13344,0.802201818,0.192636243,0.609565575
Florida,12123,Taylor County,7954,1991,9997,5963,0.795638692,0.199159748,0.596478944
Florida,12125,Union County,5224,971,6231,4253,0.838388702,0.155833735,0.682554967
Florida,12127,Volusia County,187691,120132,310495,67559,0.604489605,0.386904781,0.217584824
Florida,12129,Wakulla County,14246,5441,19856,8805,0.717465753,0.274022965,0.443442788
Florida,12131,Walton County,38970,10287,49601,28683,0.785669644,0.207395012,0.578274632
Florida,12133,Washington County,10370,2140,12584,8230,0.824062301,0.170057216,0.654005086
Georgia,13001,Appling County,6761,1560,8334,5201,0.8112551,0.187185025,0.624070074
Georgia,13003,Atkinson County,2350,700,3057,1650,0.768727511,0.228982663,0.539744848
Georgia,13005,Bacon County,4186,645,4839,3541,0.865054763,0.133292002,0.731762761
Georgia,13007,Baker County,883,590,1476,293,0.598238482,0.399728997,0.198509485
Georgia,13009,Baldwin County,9574,9159,18825,415,0.508579017,0.486533865,0.022045153
Georgia,13011,Banks County,9358,1136,10519,8222,0.889628292,0.107995057,0.781633235
Georgia,13013,Barrow County,30730,12949,43934,17781,0.699458278,0.294737561,0.404720717
Georgia,13015,Bartow County,43271,13942,57547,29329,0.751924514,0.242271535,0.509652979
Georgia,13017,Ben Hill County,4281,2199,6501,2082,0.658514075,0.338255653,0.320258422
Georgia,13019,Berrien County,6841,1209,8068,5632,0.8479177,0.149851264,0.698066435
Georgia,13021,Bibb County,26658,42172,69181,-15514,0.385337014,0.609589338,-0.224252324
Georgia,13023,Bleckley County,4685,1339,6044,3346,0.775148908,0.221542025,0.553606883
Georgia,13025,Brantley County,7744,736,8500,7008,0.911058824,0.086588235,0.824470588
Georgia,13027,Brooks County,4560,2629,7210,1931,0.632454924,0.364632455,0.267822469
Georgia,13029,Bryan County,16738,7779,24651,8959,0.678998824,0.315565291,0.363433532
Georgia,13031,Bulloch County,20985,11514,32657,9471,0.642588113,0.352573721,0.290014392
Georgia,13033,Burke County,6027,4994,11070,1033,0.544444444,0.451129178,0.093315266
Georgia,13035,Butts County,9424,3544,13019,5880,0.72386512,0.272217528,0.451647592
Georgia,13037,Calhoun County,900,1153,2056,-253,0.437743191,0.560797665,-0.123054475
Georgia,13039,Camden County,17819,8405,26393,9414,0.675141136,0.318455651,0.356685485
Georgia,13043,Candler County,3366,1196,4568,2170,0.736865149,0.261821366,0.475043783
Georgia,13045,Carroll County,42536,17634,60494,24902,0.703144113,0.291499983,0.41164413
Georgia,13047,Catoosa County,27150,7704,35038,19446,0.774872995,0.219875564,0.554997431
Georgia,13049,Charlton County,3607,1007,4628,2600,0.779386344,0.217588591,0.561797753
Georgia,13051,Chatham County,57336,82758,141109,-25422,0.406324189,0.58648279,-0.180158601
Georgia,13053,Chattahoochee County,982,703,1694,279,0.579693034,0.414994097,0.164698937
Georgia,13055,Chattooga County,8769,1896,10706,6873,0.819073417,0.177096955,0.641976462
Georgia,13057,Cherokee County,112142,48838,162281,63304,0.691035919,0.300947123,0.390088797
Georgia,13059,Clarke County,16049,36297,52887,-20248,0.303458317,0.686312326,-0.382854009
Georgia,13061,Clay County,663,771,1442,-108,0.459778086,0.534674064,-0.074895978
Georgia,13063,Clayton County,16877,94203,111729,-77326,0.151052994,0.843138308,-0.692085314
Georgia,13065,Clinch County,2201,702,2908,1499,0.756877579,0.241403026,0.515474553
Georgia,13067,Cobb County,168679,228404,401369,-59725,0.420259163,0.569062384,-0.148803221
Georgia,13069,Coffee County,11388,4295,15715,7093,0.72465797,0.273305759,0.451352211
Georgia,13071,Colquitt County,12451,4114,16611,8337,0.749563542,0.247667208,0.501896334
Georgia,13073,Columbia County,53657,31624,85920,22033,0.624499534,0.368063315,0.25643622
Georgia,13075,Cook County,5374,1956,7357,3418,0.730460786,0.26586924,0.464591545
Georgia,13077,Coweta County,57204,28111,85916,29093,0.66581312,0.327191676,0.338621444
Georgia,13079,Crawford County,4742,1582,6340,3160,0.747949527,0.249526814,0.498422713
Georgia,13081,Crisp County,5099,2993,8116,2106,0.628265155,0.368777723,0.259487432
Georgia,13083,Dade County,6804,1343,8200,5461,0.829756098,0.163780488,0.66597561
Georgia,13085,Dawson County,16115,3350,19561,12765,0.823833137,0.171259138,0.652573999
Georgia,13087,Decatur County,7140,4372,11549,2768,0.618235345,0.378560914,0.239674431
Georgia,13089,DeKalb County,62622,299630,366008,-237008,0.171094621,0.818643308,-0.647548687
Georgia,13091,Dodge County,6249,2081,8350,4168,0.748383234,0.249221557,0.499161677
Georgia,13093,Dooly County,2243,1921,4177,322,0.536988269,0.459899449,0.07708882
Georgia,13095,Dougherty County,9904,23831,33850,-13927,0.292584934,0.704017725,-0.411432792
Georgia,13097,Douglas County,23996,46240,70721,-22244,0.339305157,0.653836908,-0.314531752
Georgia,13099,Early County,2718,2158,4879,560,0.557081369,0.442303751,0.114777618
Georgia,13101,Echols County,1307,127,1438,1180,0.908901252,0.088317107,0.820584145
Georgia,13103,Effingham County,26943,9144,36244,17799,0.743378214,0.252290034,0.49108818
Georgia,13105,Elbert County,6860,2700,9589,4160,0.715403066,0.281572635,0.433830431
Georgia,13107,Emanuel County,6919,2673,9619,4246,0.719305541,0.277887514,0.441418027
Georgia,13109,Evans County,3011,1214,4244,1797,0.709472196,0.286050895,0.423421301
Georgia,13111,Fannin County,13232,2807,16096,10425,0.822067594,0.174391153,0.647676441
Georgia,13113,Fayette County,38177,35822,74633,2355,0.511529752,0.479975346,0.031554406
Georgia,13115,Floyd County,31631,12862,44738,18769,0.707027583,0.287496088,0.419531494
Georgia,13117,Forsyth County,91281,45509,138249,45772,0.660265174,0.329181405,0.331083769
Georgia,13119,Franklin County,10459,1647,12140,8812,0.861532125,0.135667216,0.725864909
Georgia,13121,Fulton County,144655,384752,535238,-240097,0.270262948,0.718842833,-0.448579884
Georgia,13123,Gilmer County,14976,3413,18481,11563,0.810345761,0.184676154,0.625669607
Georgia,13125,Glascock County,1534,133,1670,1401,0.918562874,0.079640719,0.838922156
Georgia,13127,Glynn County,27558,16144,43912,11414,0.627573328,0.36764438,0.259928949
Georgia,13129,Gordon County,22495,4982,27606,17513,0.814859089,0.180468014,0.634391074
Georgia,13131,Grady County,7385,3290,10718,4095,0.689027804,0.306960254,0.38206755
Georgia,13133,Greene County,8215,4514,12786,3701,0.642499609,0.35304239,0.289457219
Georgia,13135,Gwinnett County,173041,242507,420681,-69466,0.41133543,0.576462926,-0.165127496
Georgia,13137,Habersham County,19142,4036,23280,15106,0.822250859,0.173367698,0.648883162
Georgia,13139,Hall County,72991,28347,101973,44644,0.715787512,0.277985349,0.437802163
Georgia,13141,Hancock County,1364,2864,4240,-1500,0.321698113,0.675471698,-0.353773585
Georgia,13143,Haralson County,14239,2065,16364,12174,0.870141775,0.12619164,0.743950134
Georgia,13145,Harris County,16283,5976,22353,10307,0.728448083,0.267346665,0.461101418
Georgia,13147,Hart County,11064,3210,14331,7854,0.772032656,0.223989952,0.548042705
Georgia,13149,Heard County,5335,859,6210,4476,0.859098229,0.138325282,0.720772947
Georgia,13151,Henry County,44982,83253,129034,-38271,0.348605794,0.64520204,-0.296596246
Georgia,13153,Houston County,45090,35907,81514,9183,0.553156513,0.440501018,0.112655495
Georgia,13155,Irwin County,3340,986,4342,2354,0.769230769,0.227084293,0.542146476
Georgia,13157,Jackson County,36497,10472,47243,26025,0.77253773,0.221662469,0.550875262
Georgia,13159,Jasper County,7203,1881,9118,5322,0.789975872,0.20629524,0.583680632
Georgia,13161,Jeff Davis County,4935,924,5872,4011,0.840429155,0.157356948,0.683072207
Georgia,13163,Jefferson County,3765,3674,7463,91,0.504488811,0.492295324,0.012193488
Georgia,13165,Jenkins County,2217,1179,3409,1038,0.650337342,0.345849223,0.30448812
Georgia,13167,Johnson County,2913,1066,3984,1847,0.731174699,0.267570281,0.463604418
Georgia,13169,Jones County,11079,4959,16092,6120,0.688478747,0.308165548,0.380313199
Georgia,13171,Lamar County,7575,2795,10412,4780,0.727525932,0.268440261,0.45908567
Georgia,13173,Lanier County,2726,995,3736,1731,0.729657388,0.266327623,0.463329764
Georgia,13175,Laurens County,15460,7820,23352,7640,0.662041795,0.334874957,0.327166838
Georgia,13177,Lee County,12655,4957,17683,7698,0.715659108,0.280325737,0.435333371
Georgia,13179,Liberty County,9441,13459,23028,-4018,0.409979156,0.584462394,-0.174483238
Georgia,13181,Lincoln County,3559,1351,4931,2208,0.721760292,0.273980937,0.447779355
Georgia,13183,Long County,4557,2476,7056,2081,0.645833333,0.350907029,0.294926304
Georgia,13185,Lowndes County,28081,19487,47795,8594,0.587530076,0.407720473,0.179809604
Georgia,13187,Lumpkin County,14339,3356,17808,10983,0.80519991,0.188454627,0.616745283
Georgia,13189,McDuffie County,6562,3937,10537,2625,0.622757901,0.37363576,0.249122141
Georgia,13191,McIntosh County,4747,2628,7408,2119,0.640793737,0.35475162,0.286042117
Georgia,13193,Macon County,1916,2755,4686,-839,0.408877507,0.587921468,-0.179043961
Georgia,13195,Madison County,12951,3753,16787,9198,0.771489843,0.223565855,0.547923989
Georgia,13197,Marion County,2348,1253,3621,1095,0.648439658,0.346037006,0.302402651
Georgia,13199,Meriwether County,7375,4373,11788,3002,0.62563624,0.370970478,0.254665762
Georgia,13201,Miller County,2045,670,2724,1375,0.750734214,0.245961821,0.504772394
Georgia,13205,Mitchell County,5150,3701,8877,1449,0.580150952,0.416920131,0.163230821
Georgia,13207,Monroe County,12954,4689,17704,8265,0.731699051,0.2648554,0.466843651
Georgia,13209,Montgomery County,3033,927,3973,2106,0.76340297,0.233324943,0.530078027
Georgia,13211,Morgan County,9589,3533,13181,6056,0.727486534,0.268037326,0.459449207
Georgia,13213,Murray County,14965,2459,17468,12506,0.856709411,0.140771697,0.715937715
Georgia,13215,Muscogee County,30616,49413,80491,-18797,0.380365507,0.613894721,-0.233529214
Georgia,13217,Newton County,24893,33839,59051,-8946,0.421550863,0.573047027,-0.151496164
Georgia,13219,Oconee County,18424,8620,27287,9804,0.675193315,0.315901345,0.359291971
Georgia,13221,Oglethorpe County,6255,2515,8822,3740,0.709022897,0.285082748,0.42394015
Georgia,13223,Paulding County,58769,35802,95196,22967,0.617347368,0.376087231,0.241260137
Georgia,13225,Peach County,7104,6293,13454,811,0.528021406,0.467741935,0.060279471
Georgia,13227,Pickens County,17281,3522,20915,13759,0.826249104,0.168395888,0.657853215
Georgia,13229,Pierce County,8655,1089,9761,7566,0.886691937,0.111566438,0.775125499
Georgia,13231,Pike County,10864,1648,12549,9216,0.865726353,0.131325205,0.734401148
Georgia,13233,Polk County,15352,3749,19171,11603,0.800792864,0.195555787,0.605237077
Georgia,13235,Pulaski County,3036,1281,4336,1755,0.700184502,0.295433579,0.404750923
Georgia,13237,Putnam County,9136,3696,12877,5440,0.709482022,0.287023375,0.422458647
Georgia,13239,Quitman County,656,480,1140,176,0.575438596,0.421052632,0.154385965
Georgia,13241,Rabun County,8151,2222,10423,5929,0.782020532,0.213182385,0.568838146
Georgia,13243,Randolph County,1373,1601,2990,-228,0.459197324,0.535451505,-0.076254181
Georgia,13245,Richmond County,26472,56657,83578,-30185,0.316734069,0.677893704,-0.361159635
Georgia,13247,Rockdale County,11711,33165,45160,-21454,0.259322409,0.73438884,-0.47506643
Georgia,13249,Schley County,1970,453,2428,1517,0.811367381,0.186573311,0.624794069
Georgia,13251,Screven County,4325,2581,6920,1744,0.625,0.372976879,0.252023121
Georgia,13253,Seminole County,2811,1191,4007,1620,0.701522336,0.297229848,0.404292488
Georgia,13255,Spalding County,19184,13679,33038,5505,0.580664689,0.41403838,0.166626309
Georgia,13257,Stephens County,10632,2404,13099,8228,0.811665013,0.18352546,0.628139553
Georgia,13259,Stewart County,847,1177,2028,-330,0.41765286,0.580374753,-0.162721893
Georgia,13261,Sumter County,5869,6136,12049,-267,0.487094365,0.50925388,-0.022159515
Georgia,13263,Talbot County,1483,1888,3379,-405,0.438887245,0.558745191,-0.119857946
Georgia,13265,Taliaferro County,375,507,884,-132,0.424208145,0.573529412,-0.149321267
Georgia,13267,Tattnall County,6515,1967,8512,4548,0.765390038,0.231085526,0.534304511
Georgia,13269,Taylor County,2600,1366,3982,1234,0.652938222,0.343043697,0.309894525
Georgia,13271,Telfair County,2930,1274,4214,1656,0.695301376,0.302325581,0.392975795
Georgia,13273,Terrell County,2075,2253,4341,-178,0.478000461,0.519004838,-0.041004377
Georgia,13275,Thomas County,13670,8347,22080,5323,0.619112319,0.37803442,0.241077899
Georgia,13277,Tift County,11496,5438,16989,6058,0.676673141,0.32008947,0.356583672
Georgia,13279,Toombs County,8208,2674,10912,5534,0.752199413,0.24505132,0.507148094
Georgia,13281,Towns County,7155,1649,8838,5506,0.809572301,0.186580674,0.622991627
Georgia,13283,Treutlen County,2250,864,3121,1386,0.720922781,0.276834348,0.444088433
Georgia,13285,Troup County,19392,11757,31304,7635,0.61947355,0.375575006,0.243898543
Georgia,13287,Turner County,2457,1365,3833,1092,0.641012262,0.356117923,0.284894339
Georgia,13289,Twiggs County,2549,1895,4456,654,0.572037702,0.4252693,0.146768402
Georgia,13291,Union County,14477,3309,17880,11168,0.809675615,0.185067114,0.624608501
Georgia,13293,Upson County,9528,4098,13662,5430,0.697408871,0.299956083,0.397452789
Georgia,13295,Walker County,25462,6436,32086,19026,0.793554821,0.200585925,0.592968896
Georgia,13297,Walton County,42407,15605,58376,26802,0.7264458,0.267318761,0.459127039
Georgia,13299,Ware County,10279,4068,14392,6211,0.714216231,0.282657032,0.4315592
Georgia,13301,Warren County,1232,1354,2592,-122,0.475308642,0.522376543,-0.047067901
Georgia,13303,Washington County,4824,4643,9493,181,0.50816391,0.48909723,0.019066681
Georgia,13305,Wayne County,10811,2708,13561,8103,0.797212595,0.199690288,0.597522307
Georgia,13307,Webster County,790,544,1336,246,0.591317365,0.407185629,0.184131737
Georgia,13309,Wheeler County,1648,622,2276,1026,0.724077329,0.273286467,0.450790861
Georgia,13311,White County,14136,2609,16825,11527,0.840178306,0.155066865,0.685111441
Georgia,13313,Whitfield County,28655,10953,39828,17702,0.719468715,0.275007532,0.444461183
Georgia,13315,Wilcox County,2493,847,3347,1646,0.744846131,0.253062444,0.491783687
Georgia,13317,Wilkes County,2971,2112,5098,859,0.58277756,0.41428011,0.16849745
Georgia,13319,Wilkinson County,2888,2012,4908,876,0.588427058,0.40994295,0.178484108
Georgia,13321,Worth County,6991,2300,9309,4691,0.750993662,0.247072725,0.503920937
Hawaii,15001,Hawaii County,28748,52163,82823,-23415,0.347101651,0.629812975,-0.282711324
Hawaii,15003,Honolulu County,130489,204301,340921,-73812,0.382754362,0.599261999,-0.216507637
Hawaii,15007,Kauai County,11803,17675,30064,-5872,0.392595796,0.587912453,-0.195316658
Hawaii,15009,Maui County,22621,38905,62893,-16284,0.359674368,0.618590304,-0.258915937
Idaho,16001,Ada County,143759,116116,267340,27643,0.53773846,0.434338296,0.103400165
Idaho,16003,Adams County,2037,577,2679,1460,0.760358343,0.215378873,0.54497947
Idaho,16005,Bannock County,24329,14306,39971,10023,0.608666283,0.357909484,0.250756799
Idaho,16007,Bear Lake County,2908,346,3325,2562,0.874586466,0.10406015,0.770526316
Idaho,16009,Benewah County,4094,935,5144,3159,0.795878694,0.181765163,0.61411353
Idaho,16011,Bingham County,16188,3878,20643,12310,0.784188345,0.187860292,0.596328053
Idaho,16013,Blaine County,4281,8424,13087,-4143,0.327118515,0.643692214,-0.316573699
Idaho,16015,Boise County,3727,1065,4910,2662,0.759063136,0.216904277,0.542158859
Idaho,16017,Bonner County,21352,7650,29698,13702,0.718970974,0.257593104,0.461377871
Idaho,16019,Bonneville County,40053,14458,56419,25595,0.709920417,0.256261189,0.453659228
Idaho,16021,Boundary County,5794,1145,7110,4649,0.814908579,0.161040788,0.653867792
Idaho,16023,Butte County,1268,185,1494,1083,0.848728246,0.123828648,0.724899598
Idaho,16025,Camas County,547,153,728,394,0.751373626,0.210164835,0.541208791
Idaho,16027,Canyon County,72755,25669,101001,47086,0.720339403,0.254145999,0.466193404
Idaho,16029,Caribou County,2906,445,3456,2461,0.840856481,0.128761574,0.712094907
Idaho,16031,Cassia County,7959,1359,9557,6600,0.832792717,0.142199435,0.690593282
Idaho,16033,Clark County,280,50,333,230,0.840840841,0.15015015,0.690690691
Idaho,16035,Clearwater County,3550,774,4418,2776,0.80353101,0.175192395,0.628338615
Idaho,16037,Custer County,1998,586,2650,1412,0.753962264,0.221132075,0.532830189
Idaho,16039,Elmore County,7791,2611,10672,5180,0.730041229,0.244658921,0.485382309
Idaho,16041,Franklin County,6279,703,7184,5576,0.874025612,0.097856347,0.776169265
Idaho,16043,Fremont County,5645,954,6803,4691,0.829780979,0.14023225,0.689548729
Idaho,16045,Gem County,8707,1699,10620,7008,0.819868173,0.159981168,0.659887006
Idaho,16047,Gooding County,4676,1100,5918,3576,0.790131801,0.185873606,0.604258195
Idaho,16049,Idaho County,8148,1460,9858,6688,0.826536823,0.148103064,0.678433759
Idaho,16051,Jefferson County,13481,1891,15819,11590,0.852203047,0.119539794,0.732663253
Idaho,16053,Jerome County,6012,1742,7945,4270,0.756702329,0.219257395,0.537444934
Idaho,16055,Kootenai County,72059,22113,96340,49946,0.747965539,0.229530828,0.51843471
Idaho,16057,Latah County,10669,9039,20440,1630,0.521966732,0.442221135,0.079745597
Idaho,16059,Lemhi County,3716,1038,4873,2678,0.762569259,0.213010466,0.549558793
Idaho,16061,Lewis County,1503,305,1843,1198,0.815518177,0.165491047,0.65002713
Idaho,16063,Lincoln County,1466,392,1917,1074,0.764736568,0.204486176,0.560250391
Idaho,16065,Madison County,13925,2767,17358,11158,0.802223758,0.159407766,0.642815993
Idaho,16067,Minidoka County,6401,1373,7947,5028,0.80546118,0.172769599,0.632691582
Idaho,16069,Nez Perce County,13707,5928,20132,7779,0.680856348,0.294456587,0.386399762
Idaho,16071,Oneida County,2119,253,2457,1866,0.862433862,0.102971103,0.759462759
Idaho,16073,Owyhee County,4101,756,4950,3345,0.828484848,0.152727273,0.675757576
Idaho,16075,Payette County,9458,2064,11760,7394,0.804251701,0.175510204,0.628741497
Idaho,16077,Power County,2146,785,3019,1361,0.710831401,0.260019874,0.450811527
Idaho,16079,Shoshone County,4500,1472,6130,3028,0.734094617,0.240130506,0.493964111
Idaho,16081,Teton County,3005,3463,6698,-458,0.448641385,0.517020006,-0.06837862
Idaho,16083,Twin Falls County,27304,9064,37373,18240,0.730580901,0.242528028,0.488052872
Idaho,16085,Valley County,4214,2869,7240,1345,0.582044199,0.396270718,0.185773481
Idaho,16087,Washington County,4429,1010,5553,3419,0.79758689,0.181883666,0.615703223
Illinois,17001,Adams County,23161,8111,31744,15050,0.729618196,0.255512853,0.474105343
Illinois,17003,Alexander County,1341,904,2271,437,0.590488771,0.398062528,0.192426244
Illinois,17005,Bond County,5692,2117,7981,3575,0.713193835,0.265254981,0.447938855
Illinois,17007,Boone County,13673,10159,24216,3514,0.564626693,0.419516022,0.145110671
Illinois,17009,Brown County,1938,467,2455,1471,0.789409369,0.190224033,0.599185336
Illinois,17011,Bureau County,9784,5900,15992,3884,0.611805903,0.368934467,0.242871436
Illinois,17013,Calhoun County,2059,560,2680,1499,0.768283582,0.208955224,0.559328358
Illinois,17015,Carroll County,5082,2600,7836,2482,0.648545176,0.33180194,0.316743236
Illinois,17017,Cass County,3712,1438,5241,2274,0.708261782,0.274375119,0.433886663
Illinois,17019,Champaign County,32965,54314,88627,-21349,0.371952114,0.612838074,-0.24088596
Illinois,17021,Christian County,11278,4026,15534,7252,0.726020342,0.259173426,0.466846916
Illinois,17023,Clark County,6130,1927,8203,4203,0.747287578,0.234914056,0.512373522
Illinois,17025,Clay County,5610,1054,6766,4556,0.829145729,0.155778894,0.673366834
Illinois,17027,Clinton County,14407,4447,19215,9960,0.749778819,0.231433776,0.518345043
Illinois,17029,Coles County,13606,7495,21469,6111,0.63375099,0.349108016,0.284642974
Illinois,17031,Cook County,583852,1447821,2056800,-863969,0.283864255,0.703919195,-0.42005494
Illinois,17033,Crawford County,6727,2048,8927,4679,0.753556626,0.229416377,0.524140249
Illinois,17035,Cumberland County,4627,1059,5768,3568,0.802184466,0.183599168,0.618585298
Illinois,17037,DeKalb County,22716,23648,47186,-932,0.481413979,0.5011656,-0.019751621
Illinois,17039,De Witt County,5529,2058,7736,3471,0.714710445,0.266028956,0.448681489
Illinois,17041,Douglas County,6076,2198,8404,3878,0.722989053,0.261542123,0.46144693
Illinois,17043,DuPage County,191243,251164,449660,-59921,0.425305787,0.558564249,-0.133258462
Illinois,17045,Edgar County,5955,1816,7906,4139,0.753225398,0.229698963,0.523526436
Illinois,17047,Edwards County,2794,457,3288,2337,0.849756691,0.138990268,0.710766423
Illinois,17049,Effingham County,15124,3617,19062,11507,0.793410975,0.189749239,0.603661735
Illinois,17051,Fayette County,7847,1632,9601,6215,0.817310697,0.169982294,0.647328403
Illinois,17053,Ford County,4778,1643,6547,3135,0.729799908,0.250954636,0.478845273
Illinois,17055,Franklin County,13200,4257,17685,8943,0.74639525,0.240712468,0.505682782
Illinois,17057,Fulton County,9827,5980,16137,3847,0.608973167,0.370576935,0.238396232
Illinois,17059,Gallatin County,1923,561,2529,1362,0.760379597,0.221826809,0.538552788
Illinois,17061,Greene County,4719,1220,6054,3499,0.779484638,0.201519656,0.577964982
Illinois,17063,Grundy County,16997,9143,26539,7854,0.640453672,0.34451185,0.295941821
Illinois,17065,Hamilton County,3385,739,4181,2646,0.809614925,0.176751973,0.632862951
Illinois,17067,Hancock County,6708,2183,9058,4525,0.74056083,0.241002429,0.499558401
Illinois,17069,Hardin County,1546,357,1925,1189,0.803116883,0.185454545,0.617662338
Illinois,17071,Henderson County,2369,1026,3462,1343,0.68428654,0.296360485,0.387926054
Illinois,17073,Henry County,15359,9226,25062,6133,0.612840156,0.368127045,0.244713111
Illinois,17075,Iroquois County,10376,2747,13307,7629,0.779739986,0.206432705,0.573307282
Illinois,17077,Jackson County,10614,11394,22331,-780,0.47530339,0.510232412,-0.034929022
Illinois,17079,Jasper County,4449,912,5421,3537,0.820697288,0.168234643,0.652462645
Illinois,17081,Jefferson County,12189,4240,16639,7949,0.732556043,0.254823006,0.477733037
Illinois,17083,Jersey County,8684,2816,11691,5868,0.742793602,0.240869045,0.501924557
Illinois,17085,Jo Daviess County,7136,5051,12385,2085,0.576180864,0.407832055,0.168348809
Illinois,17087,Johnson County,4798,1241,6103,3557,0.786170736,0.203342618,0.582828117
Illinois,17089,Kane County,99260,120077,222364,-20817,0.446385206,0.540001979,-0.093616772
Illinois,17091,Kankakee County,28285,18399,47515,9886,0.595285699,0.387225087,0.208060612
Illinois,17093,Kendall County,31970,32977,65970,-1007,0.484614219,0.499878733,-0.015264514
Illinois,17095,Knox County,11917,9838,22175,2079,0.53740699,0.443652762,0.093754228
Illinois,17097,Lake County,120402,184642,309323,-64240,0.389243606,0.596922958,-0.207679351
Illinois,17099,LaSalle County,30717,21029,52432,9688,0.585844522,0.401071865,0.184772658
Illinois,17101,Lawrence County,4715,1283,6103,3432,0.772570867,0.21022448,0.562346387
Illinois,17103,Lee County,9680,6105,16091,3575,0.601578522,0.379404636,0.222173886
Illinois,17105,Livingston County,11970,4311,16538,7659,0.723787641,0.260672391,0.46311525
Illinois,17107,Logan County,8757,3543,12555,5214,0.697491039,0.282198327,0.415292712
Illinois,17109,McDonough County,6987,4736,11940,2251,0.585175879,0.396649916,0.188525963
Illinois,17111,McHenry County,83933,75370,161699,8563,0.519069382,0.466112963,0.052956419
Illinois,17113,McLean County,40290,44495,86168,-4205,0.46757497,0.516374988,-0.048800019
Illinois,17115,Macon County,26562,18009,45224,8553,0.587343004,0.39821776,0.189125243
Illinois,17117,Macoupin County,16065,6892,23403,9173,0.686450455,0.294492159,0.391958296
Illinois,17119,Madison County,73925,56341,132599,17584,0.557507975,0.424897624,0.132610352
Illinois,17121,Marion County,12409,4116,16756,8293,0.740570542,0.245643352,0.49492719
Illinois,17123,Marshall County,4119,1913,6127,2206,0.672270279,0.31222458,0.360045699
Illinois,17125,Mason County,4464,1773,6371,2691,0.700674933,0.278292262,0.422382671
Illinois,17127,Massac County,4939,1683,6676,3256,0.73981426,0.252097064,0.487717196
Illinois,17129,Menard County,4499,1834,6423,2665,0.700451502,0.285536354,0.414915149
Illinois,17131,Mercer County,5215,2950,8345,2265,0.624925105,0.353505093,0.271420012
Illinois,17133,Monroe County,14055,6473,20889,7582,0.672842166,0.309876011,0.362966154
Illinois,17135,Montgomery County,9378,3573,13187,5805,0.711154925,0.270948662,0.440206264
Illinois,17137,Morgan County,9607,4848,14649,4759,0.655812683,0.330944092,0.324868592
Illinois,17139,Moultrie County,4816,1615,6523,3201,0.738310593,0.247585467,0.490725126
Illinois,17141,Ogle County,16450,8883,25749,7567,0.638859762,0.344984271,0.29387549
Illinois,17143,Peoria County,36896,40564,78731,-3668,0.468633702,0.51522272,-0.046589018
Illinois,17145,Perry County,6949,2146,9241,4803,0.751974894,0.23222595,0.519748945
Illinois,17147,Piatt County,6104,3204,9496,2900,0.642796967,0.337405223,0.305391744
Illinois,17149,Pike County,6086,1302,7506,4784,0.810818012,0.173461231,0.637356781
Illinois,17151,Pope County,1698,416,2132,1282,0.796435272,0.195121951,0.601313321
Illinois,17153,Pulaski County,1583,769,2377,814,0.665965503,0.323517038,0.342448464
Illinois,17155,Putnam County,2014,1254,3331,760,0.604623236,0.376463524,0.228159712
Illinois,17157,Randolph County,10624,3461,14332,7163,0.741278258,0.24148758,0.499790678
Illinois,17159,Richland County,5889,1747,7743,4142,0.760557923,0.225623143,0.53493478
Illinois,17161,Rock Island County,28061,34126,63267,-6065,0.443532963,0.539396526,-0.095863562
Illinois,17163,St. Clair County,54021,63433,119655,-9412,0.451472985,0.530132464,-0.078659479
Illinois,17165,Saline County,7830,2634,10602,5196,0.738539898,0.24844369,0.490096208
Illinois,17167,Sangamon County,50979,46074,98845,4905,0.515746876,0.466123729,0.049623147
Illinois,17169,Schuyler County,2720,961,3756,1759,0.724174654,0.255857295,0.468317359
Illinois,17171,Scott County,2071,488,2587,1583,0.800541167,0.188635485,0.611905682
Illinois,17173,Shelby County,9267,2240,11664,7027,0.794495885,0.192043896,0.602451989
Illinois,17175,Stark County,1983,725,2761,1258,0.718218037,0.26258602,0.455632017
Illinois,17177,Stephenson County,12347,8278,20965,4069,0.588933938,0.394848557,0.19408538
Illinois,17179,Tazewell County,42451,24325,67966,18126,0.624591708,0.357899538,0.26669217
Illinois,17181,Union County,5837,2285,8224,3552,0.709751946,0.277845331,0.431906615
Illinois,17183,Vermilion County,19777,9254,29509,10523,0.670202311,0.313599241,0.35660307
Illinois,17185,Wabash County,4095,1200,5377,2895,0.761577088,0.223172773,0.538404315
Illinois,17187,Warren County,4579,2711,7432,1868,0.616119483,0.36477395,0.251345533
Illinois,17189,Washington County,5892,1564,7561,4328,0.779262002,0.206850946,0.572411057
Illinois,17191,Wayne County,7019,1155,8267,5864,0.849038345,0.139712108,0.709326237
Illinois,17193,White County,5586,1390,7064,4196,0.790770102,0.196772367,0.593997735
Illinois,17195,Whiteside County,14898,11012,26429,3886,0.563698967,0.416663514,0.147035453
Illinois,17197,Will County,157672,162874,324971,-5202,0.485187909,0.501195491,-0.016007582
Illinois,17199,Williamson County,22686,9890,32998,12796,0.687496212,0.299715134,0.387781078
Illinois,17201,Winnebago County,59257,59942,121048,-685,0.489533078,0.49519199,-0.005658912
Illinois,17203,Woodford County,14837,5958,21113,8879,0.702742386,0.282195804,0.420546583
Indiana,18001,Adams County,10528,3179,13959,7349,0.754208754,0.227738377,0.526470378
Indiana,18003,Allen County,90283,69960,162979,20323,0.553954804,0.429257757,0.124697047
Indiana,18005,Bartholomew County,22220,12525,35464,9695,0.626550868,0.353175051,0.273375818
Indiana,18007,Benton County,2873,1010,3954,1863,0.726605969,0.255437532,0.471168437
Indiana,18009,Blackford County,3811,1227,5135,2584,0.742161636,0.238948393,0.503213242
Indiana,18011,Boone County,22840,16426,40062,6414,0.57011632,0.410014478,0.160101842
Indiana,18013,Brown County,5647,2832,8627,2815,0.654572853,0.328271705,0.326301148
Indiana,18015,Carroll County,6902,2120,9177,4782,0.752097635,0.231012313,0.521085322
Indiana,18017,Cass County,10285,3722,14207,6563,0.723938903,0.261983529,0.461955374
Indiana,18019,Clark County,34734,22810,58570,11924,0.593033976,0.389448523,0.203585453
Indiana,18021,Clay County,9354,2495,12050,6859,0.77626556,0.207053942,0.569211618
Indiana,18023,Clinton County,9108,3135,12443,5973,0.731977819,0.251948887,0.480028932
Indiana,18025,Crawford County,3668,1235,5011,2433,0.731989623,0.246457793,0.48553183
Indiana,18027,Daviess County,9322,1963,11445,7359,0.81450415,0.171515946,0.642988204
Indiana,18029,Dearborn County,20844,5335,26588,15509,0.78396269,0.200654431,0.583308259
Indiana,18031,Decatur County,9491,2406,12111,7085,0.78366774,0.198662373,0.585005367
Indiana,18033,DeKalb County,14377,5064,19785,9313,0.726661612,0.255951478,0.470710134
Indiana,18035,Delaware County,26067,18848,45736,7219,0.569944901,0.41210425,0.157840651
Indiana,18037,Dubois County,14983,5944,21406,9039,0.699943941,0.277679155,0.422264786
Indiana,18039,Elkhart County,45652,23082,69694,22570,0.655034867,0.331190633,0.323844233
Indiana,18041,Fayette County,7625,2084,9838,5541,0.775055906,0.211831673,0.563224233
Indiana,18043,Floyd County,23408,17025,41144,6383,0.568928641,0.413790589,0.155138052
Indiana,18045,Fountain County,6311,1526,7981,4785,0.790753038,0.19120411,0.599548929
Indiana,18047,Franklin County,9810,2061,12032,7749,0.815325798,0.171293218,0.64403258
Indiana,18049,Fulton County,6633,2097,8851,4536,0.749406847,0.236922382,0.512484465
Indiana,18051,Gibson County,11896,3722,15897,8174,0.748317293,0.234132226,0.514185066
Indiana,18053,Grant County,17580,7083,25133,10497,0.699478773,0.281820714,0.417658059
Indiana,18055,Greene County,11132,3270,14633,7862,0.760746258,0.223467505,0.537278754
Indiana,18057,Hamilton County,102318,90394,196441,11924,0.52085868,0.460158521,0.060700159
Indiana,18059,Hancock County,29288,14312,44431,14976,0.659179402,0.322117441,0.337061961
Indiana,18061,Harrison County,14830,5233,20440,9597,0.72553816,0.256017613,0.469520548
Indiana,18063,Hendricks County,49783,31917,83116,17866,0.598958083,0.384005486,0.214952596
Indiana,18065,Henry County,15033,5208,20592,9825,0.730040793,0.252913753,0.47712704
Indiana,18067,Howard County,25871,12197,38778,13674,0.667156635,0.314534014,0.352622621
Indiana,18069,Huntington County,12990,4416,17720,8574,0.733069977,0.249209932,0.483860045
Indiana,18071,Jackson County,14323,4015,18653,10308,0.767865759,0.215246877,0.552618882
Indiana,18073,Jasper County,12082,3489,15821,8593,0.763668542,0.220529676,0.543138866
Indiana,18075,Jay County,6217,1747,8102,4470,0.767341397,0.215625771,0.551715626
Indiana,18077,Jefferson County,9614,4442,14325,5172,0.67113438,0.31008726,0.36104712
Indiana,18079,Jennings County,9273,2328,11809,6945,0.785248539,0.197137776,0.588110763
Indiana,18081,Johnson County,51588,24880,77794,26708,0.663135974,0.319819009,0.343316965
Indiana,18083,Knox County,11236,3625,15105,7611,0.743859649,0.239986759,0.50387289
Indiana,18085,Kosciusko County,26213,7995,34855,18218,0.752058528,0.229378855,0.522679673
Indiana,18087,LaGrange County,8073,2162,10408,5911,0.775653344,0.207724827,0.567928517
Indiana,18089,Lake County,97270,109086,209407,-11816,0.464502142,0.520928145,-0.056426003
Indiana,18091,LaPorte County,26726,20007,47529,6719,0.562309327,0.420943003,0.141366324
Indiana,18093,Lawrence County,15830,5010,21209,10820,0.746381253,0.236220472,0.510160781
Indiana,18095,Madison County,34837,19824,55716,15013,0.625260248,0.355804437,0.269455812
Indiana,18097,Marion County,124327,221719,351910,-97392,0.353292035,0.630044614,-0.276752579
Indiana,18099,Marshall County,13837,5356,19540,8481,0.708137155,0.274104401,0.434032753
Indiana,18101,Martin County,3961,933,4987,3028,0.794265089,0.187086425,0.607178665
Indiana,18103,Miami County,10670,3046,13977,7624,0.763397009,0.217929456,0.545467554
Indiana,18105,Monroe County,21004,37213,59099,-16209,0.355403645,0.629672245,-0.2742686
Indiana,18107,Montgomery County,12122,4134,16572,7988,0.731474777,0.249456915,0.482017861
Indiana,18109,Morgan County,26965,7765,35340,19200,0.763016412,0.219722694,0.543293718
Indiana,18111,Newton County,5131,1370,6601,3761,0.777306469,0.207544311,0.569762157
Indiana,18113,Noble County,14209,4462,18962,9747,0.749340787,0.235312731,0.514028056
Indiana,18115,Ohio County,2381,666,3091,1715,0.770300874,0.215464251,0.554836622
Indiana,18117,Orange County,6467,1988,8590,4479,0.752852154,0.231431898,0.521420256
Indiana,18119,Owen County,7360,2354,9875,5006,0.745316456,0.238379747,0.506936709
Indiana,18121,Parke County,5158,1371,6653,3787,0.775289343,0.206072449,0.569216895
Indiana,18123,Perry County,5549,2970,8666,2579,0.640318486,0.342718671,0.297599815
Indiana,18125,Pike County,4610,1314,6009,3296,0.767182559,0.218671992,0.548510567
Indiana,18127,Porter County,46109,37213,84877,8896,0.543244931,0.43843444,0.10481049
Indiana,18129,Posey County,9206,3572,12972,5634,0.709682393,0.275362319,0.434320074
Indiana,18131,Pulaski County,4372,1280,5761,3092,0.758896025,0.222183649,0.536712376
Indiana,18133,Putnam County,12566,3871,16731,8695,0.751060905,0.231366924,0.519693981
Indiana,18135,Randolph County,8008,2349,10547,5659,0.759268038,0.22271736,0.536550678
Indiana,18137,Ripley County,11526,2682,14384,8844,0.801307008,0.186457175,0.614849833
Indiana,18139,Rush County,5812,1675,7655,4137,0.759242325,0.218811234,0.540431091
Indiana,18141,St. Joseph County,53585,55215,110419,-1630,0.485287858,0.50004981,-0.014761952
Indiana,18143,Scott County,7633,2389,10187,5244,0.749288309,0.234514577,0.514773731
Indiana,18145,Shelby County,14438,4955,19754,9483,0.730889946,0.250835274,0.480054672
Indiana,18147,Spencer County,7364,2853,10426,4511,0.706311145,0.273642816,0.432668329
Indiana,18149,Starke County,7889,2436,10478,5453,0.752910861,0.232487116,0.520423745
Indiana,18151,Steuben County,11487,4598,16354,6889,0.702396967,0.281154458,0.421242509
Indiana,18153,Sullivan County,6639,2006,8792,4633,0.755118289,0.228161965,0.526956324
Indiana,18155,Switzerland County,3319,873,4257,2446,0.779657035,0.205073996,0.57458304
Indiana,18157,Tippecanoe County,32783,32683,66761,100,0.491050164,0.489552284,0.00149788
Indiana,18159,Tipton County,5946,1893,7976,4053,0.745486459,0.237337011,0.508149448
Indiana,18161,Union County,2698,746,3493,1952,0.772401947,0.213569997,0.55883195
Indiana,18163,Vanderburgh County,41056,31727,73794,9329,0.556359596,0.429940104,0.126419492
Indiana,18165,Vermillion County,5174,1928,7256,3246,0.71306505,0.265711136,0.447353914
Indiana,18167,Vigo County,23738,16338,40877,7400,0.580717763,0.399686865,0.181030898
Indiana,18169,Wabash County,10425,3335,13955,7090,0.74704407,0.238982444,0.508061627
Indiana,18171,Warren County,3402,898,4370,2504,0.778489703,0.205491991,0.572997712
Indiana,18173,Warrick County,21280,11292,33082,9988,0.643250106,0.341333656,0.30191645
Indiana,18175,Washington County,9739,2764,12722,6975,0.765524289,0.217261437,0.548262852
Indiana,18177,Wayne County,17526,8828,26797,8698,0.654028436,0.329439863,0.324588573
Indiana,18179,Wells County,11006,2850,14100,8156,0.780567376,0.20212766,0.578439716
Indiana,18181,White County,7969,2945,11162,5024,0.713940154,0.263841605,0.450098549
Indiana,18183,Whitley County,13122,4275,17726,8847,0.740268532,0.241171161,0.499097371
Iowa,19001,Adair County,2916,1086,4064,1830,0.717519685,0.267224409,0.450295276
Iowa,19003,Adams County,1517,576,2131,941,0.71187236,0.270295636,0.441576725
Iowa,19005,Allamakee County,4857,2350,7303,2507,0.66506915,0.321785568,0.343283582
Iowa,19007,Appanoose County,4704,1686,6466,3018,0.72749768,0.260748531,0.466749149
Iowa,19009,Audubon County,2214,970,3239,1244,0.683544304,0.299475147,0.384069157
Iowa,19011,Benton County,9549,4739,14470,4810,0.65991707,0.327505183,0.332411887
Iowa,19013,Black Hawk County,30572,31299,62653,-727,0.48795748,0.499561074,-0.011603594
Iowa,19015,Boone County,9199,5895,15346,3304,0.599439593,0.384139189,0.215300404
Iowa,19017,Bremer County,8799,5571,14556,3228,0.604492993,0.382728772,0.221764221
Iowa,19019,Buchanan County,6790,3766,10714,3024,0.633750233,0.351502707,0.282247527
Iowa,19021,Buena Vista County,4962,2462,7516,2500,0.660191591,0.327567855,0.332623736
Iowa,19023,Butler County,5784,2144,8027,3640,0.720568083,0.267098542,0.45346954
Iowa,19025,Calhoun County,3708,1328,5093,2380,0.728058119,0.260750049,0.46730807
Iowa,19027,Carroll County,7814,3153,11120,4661,0.702697842,0.283543165,0.419154676
Iowa,19029,Cass County,5007,2077,7195,2930,0.695899931,0.288672689,0.407227241
Iowa,19031,Cedar County,6390,4075,10624,2315,0.601468373,0.383565512,0.217902861
Iowa,19033,Cerro Gordo County,12627,9955,22942,2672,0.550387935,0.433920321,0.116467614
Iowa,19035,Cherokee County,4398,1611,6089,2787,0.72228609,0.264575464,0.457710626
Iowa,19037,Chickasaw County,4234,1919,6230,2315,0.679614767,0.308025682,0.371589085
Iowa,19039,Clarke County,3140,1265,4459,1875,0.704193765,0.283695896,0.420497869
Iowa,19041,Clay County,6047,2367,8514,3680,0.710241954,0.278012685,0.432229269
Iowa,19043,Clayton County,6255,3017,9381,3238,0.666773265,0.321607505,0.345165761
Iowa,19045,Clinton County,13964,9472,23813,4492,0.586402385,0.397765926,0.188636459
Iowa,19047,Crawford County,4651,1812,6525,2839,0.712796935,0.277701149,0.435095785
Iowa,19049,Dallas County,32374,29402,62633,2972,0.516884071,0.469433046,0.047451024
Iowa,19051,Davis County,3027,878,3950,2149,0.766329114,0.222278481,0.544050633
Iowa,19053,Decatur County,2711,957,3727,1754,0.727394687,0.256774886,0.470619801
Iowa,19055,Delaware County,6984,2978,10112,4006,0.690664557,0.294501582,0.396162975
Iowa,19057,Des Moines County,10794,7935,18998,2859,0.56816507,0.417675545,0.150489525
Iowa,19059,Dickinson County,7775,3297,11192,4478,0.694692638,0.294585418,0.400107219
Iowa,19061,Dubuque County,28224,23705,52566,4519,0.536925009,0.450956892,0.085968116
Iowa,19063,Emmet County,3422,1315,4786,2107,0.715002089,0.274759716,0.440242374
Iowa,19065,Fayette County,6325,3334,9817,2991,0.644290516,0.339614954,0.304675563
Iowa,19067,Floyd County,4744,2782,7625,1962,0.622163934,0.364852459,0.257311475
Iowa,19069,Franklin County,3431,1393,4885,2038,0.702354145,0.285158649,0.417195496
Iowa,19071,Fremont County,2711,1023,3785,1688,0.716248349,0.270277411,0.445970938
Iowa,19073,Greene County,3211,1603,4874,1608,0.658801805,0.328887977,0.329913828
Iowa,19075,Grundy County,4998,2019,7131,2979,0.700883467,0.283129996,0.417753471
Iowa,19077,Guthrie County,4446,1974,6514,2472,0.682529936,0.303039607,0.379490329
Iowa,19079,Hamilton County,5004,2482,7573,2522,0.66076852,0.327743299,0.333025221
Iowa,19081,Hancock County,4336,1523,5933,2813,0.730827575,0.256699815,0.47412776
Iowa,19083,Hardin County,5790,2553,8434,3237,0.686506995,0.302703344,0.383803652
Iowa,19085,Harrison County,5566,2245,7938,3321,0.701184177,0.28281683,0.418367347
Iowa,19087,Henry County,6439,2995,9574,3444,0.672550658,0.312826405,0.359724253
Iowa,19089,Howard County,3157,1619,4837,1538,0.652677279,0.334711598,0.317965681
Iowa,19091,Humboldt County,3770,1236,5067,2534,0.744029998,0.24393132,0.500098678
Iowa,19093,Ida County,2771,826,3642,1945,0.760845689,0.226798462,0.534047227
Iowa,19095,Iowa County,6068,3400,9617,2668,0.630965998,0.353540605,0.277425393
Iowa,19097,Jackson County,7074,3567,10782,3507,0.656093489,0.33082916,0.325264329
Iowa,19099,Jasper County,12701,7141,20149,5560,0.630353864,0.354409648,0.275944216
Iowa,19101,Jefferson County,4353,3788,8317,565,0.523385836,0.455452687,0.067933149
Iowa,19103,Johnson County,26087,58846,86068,-32759,0.303097551,0.683715202,-0.380617651
Iowa,19105,Jones County,6820,3942,10949,2878,0.622887935,0.36003288,0.262855055
Iowa,19107,Keokuk County,3869,1219,5142,2650,0.752430961,0.237067289,0.515363672
Iowa,19109,Kossuth County,5983,2284,8376,3699,0.71430277,0.272683859,0.441618911
Iowa,19111,Lee County,10152,5659,16154,4493,0.628451158,0.350315711,0.278135446
Iowa,19113,Linn County,54237,66358,122369,-12121,0.443225,0.542277864,-0.099052865
Iowa,19115,Louisa County,3584,1480,5136,2104,0.697819315,0.288161994,0.409657321
Iowa,19117,Lucas County,3400,1169,4639,2231,0.732916577,0.251993964,0.480922613
Iowa,19119,Lyon County,5899,1023,6984,4876,0.844644903,0.146477663,0.698167239
Iowa,19121,Madison County,6864,3008,9995,3856,0.686743372,0.300950475,0.385792896
Iowa,19123,Mahaska County,8207,2577,10910,5630,0.752245646,0.236205316,0.51604033
Iowa,19125,Marion County,13289,5928,19490,7361,0.681836839,0.304155977,0.377680862
Iowa,19127,Marshall County,9815,7134,17217,2681,0.570076088,0.414357902,0.155718186
Iowa,19129,Mills County,5671,2456,8223,3215,0.689650979,0.29867445,0.390976529
Iowa,19131,Mitchell County,3736,1943,5757,1793,0.648949105,0.337502171,0.311446934
Iowa,19133,Monona County,3331,1236,4616,2095,0.721620451,0.267764298,0.453856153
Iowa,19135,Monroe County,3104,1002,4146,2102,0.74867342,0.241678726,0.506994694
Iowa,19137,Montgomery County,3486,1508,5061,1978,0.68879668,0.297964829,0.390831851
Iowa,19139,Muscatine County,11152,8212,19695,2940,0.566235085,0.416958619,0.149276466
Iowa,19141,O'Brien County,5998,1428,7501,4570,0.799626716,0.190374617,0.6092521
Iowa,19143,Osceola County,2623,555,3219,2068,0.814849332,0.172413793,0.642435539
Iowa,19145,Page County,5153,2060,7297,3093,0.706180622,0.282307798,0.423872824
Iowa,19147,Palo Alto County,3576,1338,4976,2238,0.718649518,0.268890675,0.449758842
Iowa,19149,Plymouth County,10661,3104,13931,7557,0.765271696,0.222812433,0.542459264
Iowa,19151,Pocahontas County,2727,796,3573,1931,0.763224181,0.222781976,0.540442205
Iowa,19153,Polk County,112240,140075,255563,-27835,0.439187206,0.548103599,-0.108916392
Iowa,19155,Pottawattamie County,26335,17468,44411,8867,0.59298372,0.393325978,0.199657742
Iowa,19157,Poweshiek County,5758,4067,9971,1691,0.577474677,0.40788286,0.169591816
Iowa,19159,Ringgold County,2015,638,2683,1377,0.751024972,0.237793515,0.513231457
Iowa,19161,Sac County,4100,1289,5448,2811,0.75256975,0.236600587,0.515969163
Iowa,19163,Scott County,45976,42479,89743,3497,0.512307367,0.473340539,0.038966827
Iowa,19165,Shelby County,4600,1811,6486,2789,0.709219858,0.279216775,0.430003084
Iowa,19167,Sioux County,16053,2626,18881,13427,0.850219798,0.139081616,0.711138181
Iowa,19169,Story County,21665,26765,49200,-5100,0.440345528,0.544004065,-0.103658537
Iowa,19171,Tama County,5379,3070,8594,2309,0.625901792,0.357225972,0.26867582
Iowa,19173,Taylor County,2381,666,3078,1715,0.773554256,0.216374269,0.557179987
Iowa,19175,Union County,4044,1874,5996,2170,0.674449633,0.312541694,0.361907939
Iowa,19177,Van Buren County,2785,778,3622,2007,0.768912203,0.214798454,0.554113749
Iowa,19179,Wapello County,9479,4896,14571,4583,0.650538741,0.336009883,0.314528859
Iowa,19181,Warren County,19486,12712,32662,6774,0.596595432,0.389198457,0.207396975
Iowa,19183,Washington County,7119,4297,11551,2822,0.616310276,0.372002424,0.244307852
Iowa,19185,Wayne County,2426,643,3119,1783,0.777813402,0.206155819,0.571657583
Iowa,19187,Webster County,10850,5641,16706,5209,0.649467257,0.337663115,0.311804142
Iowa,19189,Winnebago County,3636,1909,5627,1727,0.646170251,0.339257153,0.306913098
Iowa,19191,Winneshiek County,6427,5321,11927,1106,0.538861407,0.446130628,0.092730779
Iowa,19193,Woodbury County,25969,16145,42674,9824,0.608543844,0.378333411,0.230210433
Iowa,19195,Worth County,2715,1508,4278,1207,0.634642356,0.352501169,0.282141187
Iowa,19197,Wright County,3853,1770,5706,2083,0.675254118,0.31019979,0.365054329
Kansas,20001,Allen County,4029,1445,5600,2584,0.719464286,0.258035714,0.461428571
Kansas,20003,Anderson County,2998,732,3791,2266,0.790820364,0.193088895,0.597731469
Kansas,20005,Atchison County,4911,2201,7255,2710,0.676912474,0.303376981,0.373535493
Kansas,20007,Barber County,1854,288,2170,1566,0.85437788,0.132718894,0.721658986
Kansas,20009,Barton County,8205,2207,10570,5998,0.776253548,0.208798486,0.567455061
Kansas,20011,Bourbon County,5003,1444,6572,3559,0.76125989,0.219720024,0.541539866
Kansas,20013,Brown County,3106,1065,4258,2041,0.729450446,0.250117426,0.47933302
Kansas,20015,Butler County,22426,9150,32236,13276,0.695681846,0.283844149,0.411837697
Kansas,20017,Chase County,1090,348,1462,742,0.745554036,0.238030096,0.50752394
Kansas,20019,Chautauqua County,1299,211,1527,1088,0.850687623,0.138179437,0.712508186
Kansas,20021,Cherokee County,6584,1970,8717,4614,0.755305724,0.225995182,0.529310543
Kansas,20023,Cheyenne County,1185,206,1422,979,0.833333333,0.144866385,0.688466948
Kansas,20025,Clark County,867,129,1014,738,0.855029586,0.127218935,0.727810651
Kansas,20027,Clay County,3150,867,4113,2283,0.765864333,0.21079504,0.555069292
Kansas,20029,Cloud County,3218,767,4047,2451,0.795156906,0.189523104,0.605633803
Kansas,20031,Coffey County,3371,934,4377,2437,0.770162212,0.213388165,0.556774046
Kansas,20033,Comanche County,727,130,874,597,0.83180778,0.148741419,0.683066362
Kansas,20035,Cowley County,9360,3919,13505,5441,0.693076638,0.290188819,0.402887819
Kansas,20037,Crawford County,10084,5956,16334,4128,0.617362557,0.364638178,0.252724379
Kansas,20039,Decatur County,1217,215,1452,1002,0.83815427,0.148071625,0.690082645
Kansas,20041,Dickinson County,7014,1989,9144,5025,0.767060367,0.217519685,0.549540682
Kansas,20043,Doniphan County,2899,626,3577,2273,0.810455689,0.175006989,0.6354487
Kansas,20045,Douglas County,17523,39582,58041,-22059,0.301907272,0.681966196,-0.380058924
Kansas,20047,Edwards County,1042,213,1269,829,0.821118991,0.1678487,0.653270292
Kansas,20049,Elk County,1123,191,1338,932,0.839312407,0.142750374,0.696562033
Kansas,20051,Ellis County,9743,3511,13511,6232,0.721116128,0.259862334,0.461253793
Kansas,20053,Ellsworth County,2078,636,2758,1442,0.753444525,0.230601885,0.52284264
Kansas,20055,Finney County,7166,3425,10782,3741,0.664626229,0.317659061,0.346967168
Kansas,20057,Ford County,5616,2461,8224,3155,0.682879377,0.299246109,0.383633268
Kansas,20059,Franklin County,8773,3676,12708,5097,0.690352534,0.289266604,0.40108593
Kansas,20061,Geary County,5288,3674,9163,1614,0.577103569,0.400960384,0.176143185
Kansas,20063,Gove County,1227,150,1396,1077,0.878939828,0.107449857,0.771489971
Kansas,20065,Graham County,1055,210,1287,845,0.81973582,0.163170163,0.656565657
Kansas,20067,Grant County,1793,395,2220,1398,0.807657658,0.177927928,0.62972973
Kansas,20069,Gray County,1837,324,2193,1513,0.837665299,0.147742818,0.689922481
Kansas,20071,Greeley County,510,75,593,435,0.860033727,0.126475548,0.733558179
Kansas,20073,Greenwood County,2299,541,2884,1758,0.797156727,0.187586685,0.609570042
Kansas,20075,Hamilton County,671,131,815,540,0.823312883,0.160736196,0.662576687
Kansas,20077,Harper County,2072,437,2555,1635,0.810958904,0.171037182,0.639921722
Kansas,20079,Harvey County,9591,6202,16086,3389,0.596232749,0.385552654,0.210680094
Kansas,20081,Haskell County,1045,221,1278,824,0.817683881,0.172926448,0.644757433
Kansas,20083,Hodgeman County,817,136,966,681,0.845755694,0.140786749,0.704968944
Kansas,20085,Jackson County,4557,1799,6474,2758,0.703892493,0.277880754,0.426011739
Kansas,20087,Jefferson County,6694,3030,9927,3664,0.674322555,0.305228166,0.369094389
Kansas,20089,Jewell County,1370,176,1574,1194,0.870393901,0.111817027,0.758576874
Kansas,20091,Johnson County,154247,183451,343780,-29204,0.448679388,0.533629065,-0.084949677
Kansas,20093,Kearny County,1082,192,1301,890,0.831667948,0.147578786,0.684089162
Kansas,20095,Kingman County,3119,753,3947,2366,0.790220421,0.190777806,0.599442615
Kansas,20097,Kiowa County,941,151,1107,790,0.850045167,0.136404697,0.71364047
Kansas,20099,Labette County,5410,2385,7921,3025,0.682994571,0.301098346,0.381896225
Kansas,20101,Lane County,709,111,843,598,0.841043891,0.131672598,0.709371293
Kansas,20103,Leavenworth County,22055,13732,36547,8323,0.603469505,0.375735354,0.227734151
Kansas,20105,Lincoln County,1233,250,1507,983,0.818181818,0.165892502,0.652289317
Kansas,20107,Linn County,4093,854,5016,3239,0.815988836,0.170255183,0.645733652
Kansas,20109,Logan County,1186,183,1400,1003,0.847142857,0.130714286,0.716428571
Kansas,20111,Lyon County,7462,5515,13256,1947,0.562914906,0.416038021,0.146876886
Kansas,20113,McPherson County,9816,4021,14104,5795,0.695972774,0.285096427,0.410876347
Kansas,20115,Marion County,4312,1429,5870,2883,0.734582624,0.243441227,0.491141397
Kansas,20117,Marshall County,3644,1205,4968,2439,0.733494364,0.242552335,0.490942029
Kansas,20119,Meade County,1427,247,1695,1180,0.841887906,0.145722714,0.696165192
Kansas,20121,Miami County,12854,5472,18685,7382,0.687931496,0.292855231,0.395076264
Kansas,20123,Mitchell County,2608,528,3172,2080,0.822194199,0.166456494,0.655737705
Kansas,20125,Montgomery County,9287,2934,12441,6353,0.746483402,0.235833132,0.510650269
Kansas,20127,Morris County,2021,721,2792,1300,0.723853868,0.258237822,0.465616046
Kansas,20129,Morton County,909,131,1060,778,0.85754717,0.123584906,0.733962264
Kansas,20131,Nemaha County,4655,888,5620,3767,0.828291815,0.158007117,0.670284698
Kansas,20133,Neosho County,4961,1696,6784,3265,0.731279481,0.25,0.481279481
Kansas,20135,Ness County,1205,129,1363,1076,0.884079237,0.094644167,0.78943507
Kansas,20137,Norton County,1882,346,2270,1536,0.82907489,0.152422907,0.676651982
Kansas,20139,Osage County,5736,1946,7892,3790,0.726811961,0.246578814,0.480233147
Kansas,20141,Osborne County,1477,261,1774,1216,0.832581736,0.147125141,0.685456595
Kansas,20143,Ottawa County,2475,476,3003,1999,0.824175824,0.158508159,0.665667666
Kansas,20145,Pawnee County,2003,625,2675,1378,0.748785047,0.23364486,0.515140187
Kansas,20147,Phillips County,2356,331,2747,2025,0.857662905,0.120495086,0.737167819
Kansas,20149,Pottawatomie County,9811,3394,13472,6417,0.728251188,0.251929929,0.476321259
Kansas,20151,Pratt County,3054,954,4082,2100,0.748162665,0.233708966,0.514453699
Kansas,20153,Rawlins County,1194,176,1403,1018,0.8510335,0.125445474,0.725588026
Kansas,20155,Reno County,17847,8554,26940,9293,0.66247216,0.317520416,0.344951745
Kansas,20157,Republic County,2001,396,2443,1605,0.819074908,0.162095784,0.656979124
Kansas,20159,Rice County,3073,825,3966,2248,0.774836107,0.208018154,0.566817953
Kansas,20161,Riley County,11630,12063,24313,-433,0.478344918,0.496154321,-0.017809402
Kansas,20163,Rooks County,2153,349,2534,1804,0.84964483,0.137726914,0.711917916
Kansas,20165,Rush County,1315,264,1606,1051,0.818804483,0.164383562,0.654420922
Kansas,20167,Russell County,2632,608,3301,2024,0.797334141,0.18418661,0.613147531
Kansas,20169,Saline County,15069,7734,23226,7335,0.64879876,0.332988892,0.315809868
Kansas,20171,Scott County,1843,248,2135,1595,0.86323185,0.116159251,0.7470726
Kansas,20173,Sedgwick County,120118,90506,214152,29612,0.560900669,0.422625051,0.138275617
Kansas,20175,Seward County,3133,1354,4565,1779,0.686308872,0.2966046,0.389704272
Kansas,20177,Shawnee County,39901,40308,81819,-407,0.487674012,0.492648407,-0.004974395
Kansas,20179,Sheridan County,1229,126,1373,1103,0.895120175,0.091769847,0.803350328
Kansas,20181,Sherman County,2161,379,2593,1782,0.833397609,0.146162746,0.687234863
Kansas,20183,Smith County,1675,300,2006,1375,0.834995015,0.149551346,0.685443669
Kansas,20185,Stafford County,1548,326,1909,1222,0.810895757,0.170770037,0.64012572
Kansas,20187,Stanton County,537,115,664,422,0.80873494,0.173192771,0.635542169
Kansas,20189,Stevens County,1595,210,1835,1385,0.869209809,0.114441417,0.754768392
Kansas,20191,Sumner County,7810,2527,10549,5283,0.740354536,0.239548772,0.500805764
Kansas,20193,Thomas County,3007,597,3664,2410,0.820687773,0.162936681,0.657751092
Kansas,20195,Trego County,1343,216,1587,1127,0.846250788,0.13610586,0.710144928
Kansas,20197,Wabaunsee County,2816,944,3836,1872,0.734098019,0.246089677,0.488008342
Kansas,20199,Wallace County,686,52,748,634,0.917112299,0.069518717,0.847593583
Kansas,20201,Washington County,2263,396,2700,1867,0.838148148,0.146666667,0.691481481
Kansas,20203,Wichita County,740,107,860,633,0.860465116,0.124418605,0.736046512
Kansas,20205,Wilson County,2894,647,3603,2247,0.803219539,0.179572578,0.623646961
Kansas,20207,Woodson County,1205,282,1506,923,0.800132802,0.187250996,0.612881806
Kansas,20209,Wyandotte County,18867,30938,50602,-12071,0.372850875,0.611398759,-0.238547883
Kentucky,21001,Adair County,7643,1257,8971,6386,0.851967451,0.140118159,0.711849292
Kentucky,21003,Allen County,7824,1505,9418,6319,0.830749628,0.159800382,0.670949246
Kentucky,21005,Anderson County,9650,3226,13090,6424,0.737203972,0.24644767,0.490756303
Kentucky,21007,Ballard County,3331,697,4088,2634,0.814823875,0.170499022,0.644324853
Kentucky,21009,Barren County,15019,4565,19799,10454,0.758573665,0.2305672,0.528006465
Kentucky,21011,Bath County,4041,1278,5389,2763,0.749860828,0.237149749,0.512711078
Kentucky,21013,Bell County,7831,1419,9337,6412,0.838706223,0.151976009,0.686730213
Kentucky,21015,Boone County,45650,20601,67382,25049,0.677480633,0.305734469,0.371746164
Kentucky,21017,Bourbon County,6284,3088,9535,3196,0.659045621,0.323859465,0.335186156
Kentucky,21019,Boyd County,14363,6291,20951,8072,0.685552002,0.300272063,0.385279939
Kentucky,21021,Boyle County,9159,4990,14371,4169,0.637325169,0.347227054,0.290098114
Kentucky,21023,Bracken County,3399,702,4146,2697,0.819826339,0.169319826,0.650506512
Kentucky,21025,Breathitt County,4036,1002,5113,3034,0.789360454,0.195971054,0.5933894
Kentucky,21027,Breckinridge County,7882,2038,10046,5844,0.784590882,0.202866813,0.581724069
Kentucky,21029,Bullitt County,32299,10280,43187,22019,0.747887096,0.238034594,0.509852502
Kentucky,21031,Butler County,4905,965,5942,3940,0.825479636,0.162403231,0.663076405
Kentucky,21033,Caldwell County,4860,1256,6188,3604,0.78539108,0.202973497,0.582417582
Kentucky,21035,Calloway County,11539,5111,16936,6428,0.681329712,0.301783184,0.379546528
Kentucky,21037,Campbell County,28450,18952,48302,9498,0.589002526,0.392364705,0.19663782
Kentucky,21039,Carlisle County,2182,408,2610,1774,0.836015326,0.156321839,0.679693487
Kentucky,21041,Carroll County,3014,963,4025,2051,0.748819876,0.239254658,0.509565217
Kentucky,21043,Carter County,8981,2305,11420,6676,0.78642732,0.201838879,0.584588441
Kentucky,21045,Casey County,6216,804,7080,5412,0.877966102,0.113559322,0.76440678
Kentucky,21047,Christian County,14332,7055,21671,7277,0.661344654,0.325550275,0.33579438
Kentucky,21049,Clark County,11950,5639,17868,6311,0.668793374,0.31559212,0.353201254
Kentucky,21051,Clay County,6729,692,7517,6037,0.895170946,0.092058002,0.803112944
Kentucky,21053,Clinton County,4276,549,4880,3727,0.876229508,0.1125,0.763729508
Kentucky,21055,Crittenden County,3349,608,4008,2741,0.835578842,0.151696607,0.683882236
Kentucky,21057,Cumberland County,2922,483,3439,2439,0.8496656,0.140447805,0.709217796
Kentucky,21059,Daviess County,30705,15673,47067,15032,0.652367901,0.332993392,0.319374509
Kentucky,21061,Edmonson County,5048,1118,6247,3930,0.808067873,0.178965904,0.629101969
Kentucky,21063,Elliott County,2335,532,2911,1803,0.802129852,0.182755067,0.619374785
Kentucky,21065,Estill County,5091,1114,6289,3977,0.809508666,0.17713468,0.632373986
Kentucky,21067,Fayette County,57347,83387,143762,-26040,0.398902352,0.580035058,-0.181132705
Kentucky,21069,Fleming County,5578,1334,7000,4244,0.796857143,0.190571429,0.606285714
Kentucky,21071,Floyd County,12326,3061,15650,9265,0.787603834,0.195591054,0.59201278
Kentucky,21073,Franklin County,13246,11996,25749,1250,0.514427745,0.46588217,0.048545575
Kentucky,21075,Fulton County,1491,636,2145,855,0.695104895,0.296503497,0.398601399
Kentucky,21077,Gallatin County,3109,761,3917,2348,0.793719683,0.194281338,0.599438346
Kentucky,21079,Garrard County,7086,1719,8917,5367,0.794661882,0.19277784,0.601884042
Kentucky,21081,Grant County,9372,1944,11466,7428,0.817373103,0.169544741,0.647828362
Kentucky,21083,Graves County,13378,3105,16678,10273,0.802134549,0.186173402,0.615961146
Kentucky,21085,Grayson County,9710,2235,12095,7475,0.802811079,0.184787102,0.618023977
Kentucky,21087,Green County,5033,782,5857,4251,0.859313642,0.133515452,0.72579819
Kentucky,21089,Greenup County,12961,4181,17372,8780,0.746085655,0.240674649,0.505411006
Kentucky,21091,Hancock County,3375,1173,4633,2202,0.728469674,0.253183682,0.475285992
Kentucky,21093,Hardin County,30672,16572,48060,14100,0.638202247,0.344818976,0.293383271
Kentucky,21095,Harlan County,9109,1199,10384,7910,0.877214946,0.115466102,0.761748844
Kentucky,21097,Harrison County,6639,2265,9018,4374,0.736194278,0.251164338,0.48502994
Kentucky,21099,Hart County,6691,1642,8409,5049,0.795695089,0.195266976,0.600428113
Kentucky,21101,Henderson County,12592,6837,19684,5755,0.639707377,0.347337939,0.292369437
Kentucky,21103,Henry County,6093,1857,8074,4236,0.754644538,0.229997523,0.524647015
Kentucky,21105,Hickman County,1656,394,2069,1262,0.80038666,0.190430159,0.609956501
Kentucky,21107,Hopkins County,15361,4916,20532,10445,0.74814923,0.239431132,0.508718099
Kentucky,21109,Jackson County,5358,506,5934,4852,0.902932255,0.085271318,0.817660937
Kentucky,21111,Jefferson County,144553,203070,353609,-58517,0.408793328,0.57427837,-0.165485041
Kentucky,21113,Jessamine County,17854,8303,26644,9551,0.67009458,0.311627383,0.358467197
Kentucky,21115,Johnson County,8150,1350,9622,6800,0.847017252,0.140303471,0.706713781
Kentucky,21117,Kenton County,48444,30859,80875,17585,0.598998454,0.381564142,0.217434312
Kentucky,21119,Knott County,4732,1181,6003,3551,0.78827253,0.196734966,0.591537565
Kentucky,21121,Knox County,11178,1821,13156,9357,0.84965035,0.138415932,0.711234418
Kentucky,21123,Larue County,5773,1389,7258,4384,0.795398181,0.191375034,0.604023147
Kentucky,21125,Laurel County,23516,4037,27884,19479,0.843351026,0.144778368,0.698572658
Kentucky,21127,Lawrence County,5464,1044,6572,4420,0.831405965,0.158855752,0.672550213
Kentucky,21129,Lee County,2227,406,2690,1821,0.827881041,0.150929368,0.676951673
Kentucky,21131,Leslie County,3908,382,4357,3526,0.896947441,0.087675006,0.809272435
Kentucky,21133,Letcher County,6848,1457,8430,5391,0.812336892,0.172835113,0.639501779
Kentucky,21135,Lewis County,4997,666,5721,4331,0.873448698,0.116413214,0.757035483
Kentucky,21137,Lincoln County,8833,2080,11034,6753,0.800525648,0.188508247,0.612017401
Kentucky,21139,Livingston County,4021,886,4972,3135,0.808728882,0.178197908,0.630530973
Kentucky,21141,Logan County,9620,2734,12506,6886,0.769230769,0.218615065,0.550615704
Kentucky,21143,Lyon County,3187,950,4187,2237,0.761165512,0.226892763,0.534272749
Kentucky,21145,McCracken County,21349,10191,31937,11158,0.668472305,0.319096972,0.349375333
Kentucky,21147,McCreary County,5531,641,6211,4890,0.890516825,0.103203993,0.787312832
Kentucky,21149,McLean County,3578,989,4633,2589,0.772285776,0.213468595,0.558817181
Kentucky,21151,Madison County,29130,15180,45164,13950,0.64498273,0.336108405,0.308874325
Kentucky,21153,Magoffin County,4288,909,5274,3379,0.813045127,0.172354949,0.640690178
Kentucky,21155,Marion County,6473,2513,9100,3960,0.711318681,0.276153846,0.435164835
Kentucky,21157,Marshall County,13677,3700,17599,9977,0.777146429,0.210239218,0.566907211
Kentucky,21159,Martin County,3343,287,3655,3056,0.914637483,0.078522572,0.836114911
Kentucky,21161,Mason County,5621,2170,7898,3451,0.711699164,0.274753102,0.436946062
Kentucky,21163,Meade County,10630,3279,14119,7351,0.752886182,0.232240244,0.520645938
Kentucky,21165,Menifee County,2563,664,3292,1899,0.77855407,0.201701094,0.576852977
Kentucky,21167,Mercer County,8826,2838,11841,5988,0.745376235,0.239675703,0.505700532
Kentucky,21169,Metcalfe County,4197,884,5124,3313,0.819086651,0.172521468,0.646565183
Kentucky,21171,Monroe County,4679,576,5308,4103,0.881499623,0.108515448,0.772984175
Kentucky,21173,Montgomery County,9302,3329,12819,5973,0.725641626,0.259692644,0.465948982
Kentucky,21175,Morgan County,4353,939,5373,3414,0.810161921,0.174762702,0.635399218
Kentucky,21177,Muhlenberg County,10491,3048,13691,7443,0.766269812,0.222628004,0.543641808
Kentucky,21179,Nelson County,16052,6515,22838,9537,0.702863648,0.285270164,0.417593485
Kentucky,21181,Nicholas County,2451,824,3319,1627,0.738475444,0.24826755,0.490207894
Kentucky,21183,Ohio County,8679,2094,10935,6585,0.793689986,0.191495199,0.602194787
Kentucky,21185,Oldham County,23025,14402,38187,8623,0.602953885,0.377144054,0.225809831
Kentucky,21187,Owen County,4434,988,5494,3446,0.80706225,0.179832545,0.627229705
Kentucky,21189,Owsley County,1625,203,1839,1422,0.883632409,0.110386079,0.77324633
Kentucky,21191,Pendleton County,5593,1210,6900,4383,0.81057971,0.175362319,0.635217391
Kentucky,21193,Perry County,7913,1966,9992,5947,0.791933547,0.196757406,0.595176141
Kentucky,21195,Pike County,19684,4025,23946,15659,0.822016203,0.168086528,0.653929675
Kentucky,21197,Powell County,4092,1174,5360,2918,0.763432836,0.219029851,0.544402985
Kentucky,21199,Pulaski County,26051,5351,31725,20700,0.821150512,0.168668243,0.65248227
Kentucky,21201,Robertson County,915,215,1144,700,0.799825175,0.187937063,0.611888112
Kentucky,21203,Rockcastle County,6635,986,7724,5649,0.859010875,0.127654065,0.73135681
Kentucky,21205,Rowan County,6224,3484,9872,2740,0.630470016,0.352917342,0.277552674
Kentucky,21207,Russell County,7622,1200,8893,6422,0.857078601,0.134937591,0.72214101
Kentucky,21209,Scott County,18747,10501,29761,8246,0.62991835,0.352844326,0.277074023
Kentucky,21211,Shelby County,16356,7822,24607,8534,0.66468891,0.317877027,0.346811883
Kentucky,21213,Simpson County,6253,2403,8776,3850,0.712511395,0.27381495,0.438696445
Kentucky,21215,Spencer County,8927,2415,11479,6512,0.777680983,0.21038418,0.567296803
Kentucky,21217,Taylor County,9523,2576,12256,6947,0.77700718,0.210182768,0.566824413
Kentucky,21219,Todd County,4009,1051,5112,2958,0.784233177,0.205594679,0.578638498
Kentucky,21221,Trigg County,5436,1667,7196,3769,0.755419678,0.231656476,0.523763202
Kentucky,21223,Trimble County,3283,923,4249,2360,0.772652389,0.217227583,0.555424806
Kentucky,21225,Union County,4758,1225,6058,3533,0.785407725,0.202211951,0.583195774
Kentucky,21227,Warren County,34862,21065,56860,13797,0.613119944,0.370471333,0.242648611
Kentucky,21229,Washington County,4720,1533,6338,3187,0.744714421,0.241874408,0.502840013
Kentucky,21231,Wayne County,7203,1444,8733,5759,0.824802473,0.165349823,0.659452651
Kentucky,21233,Webster County,4339,1153,5556,3186,0.780957523,0.207523398,0.573434125
Kentucky,21235,Whitley County,12687,2237,15075,10450,0.84159204,0.148391376,0.693200663
Kentucky,21237,Wolfe County,2163,689,2915,1474,0.742024014,0.236363636,0.505660377
Kentucky,21239,Woodford County,8419,6282,14984,2137,0.56186599,0.419247197,0.142618793
Louisiana,22001,Acadia Parish,21783,4695,26720,17088,0.815232036,0.175711078,0.639520958
Louisiana,22003,Allen Parish,7003,1661,8751,5342,0.8002514,0.189806879,0.610444521
Louisiana,22005,Ascension Parish,41319,20113,62473,21206,0.66138972,0.321947081,0.339442639
Louisiana,22007,Assumption Parish,6963,3273,10367,3690,0.671650429,0.315713321,0.355937108
Louisiana,22009,Avoyelles Parish,11379,4460,16037,6919,0.709546673,0.278106878,0.431439795
Louisiana,22011,Beauregard Parish,13504,2192,15874,11312,0.850699257,0.138087439,0.712611818
Louisiana,22013,Bienville Parish,3660,2531,6256,1129,0.585038363,0.404571611,0.180466752
Louisiana,22015,Bossier Parish,37105,14467,52232,22638,0.710388268,0.2769758,0.433412467
Louisiana,22017,Caddo Parish,44471,48864,94699,-4393,0.469603692,0.515992777,-0.046389085
Louisiana,22019,Calcasieu Parish,56064,23918,81201,32146,0.690434847,0.294553023,0.395881824
Louisiana,22021,Caldwell Parish,3724,580,4334,3144,0.859252423,0.133825565,0.725426857
Louisiana,22023,Cameron Parish,3120,219,3362,2901,0.928019036,0.065139798,0.862879239
Louisiana,22025,Catahoula Parish,3258,1060,4348,2198,0.749310028,0.243790248,0.505519779
Louisiana,22027,Claiborne Parish,3522,2239,5816,1283,0.605570839,0.38497249,0.220598349
Louisiana,22029,Concordia Parish,4974,2698,7755,2276,0.64139265,0.347904578,0.293488072
Louisiana,22031,De Soto Parish,9359,4426,13913,4933,0.672680227,0.318119744,0.354560483
Louisiana,22033,East Baton Rouge Parish,82720,103820,190643,-21100,0.433900012,0.544578086,-0.110678074
Louisiana,22035,East Carroll Parish,931,1338,2306,-407,0.403729402,0.580225499,-0.176496097
Louisiana,22037,East Feliciana Parish,6020,3809,9947,2211,0.6052076,0.382929526,0.222278074
Louisiana,22039,Evangeline Parish,10483,3526,14176,6957,0.739489278,0.248730248,0.490759029
Louisiana,22041,Franklin Parish,6524,2196,8798,4328,0.741532166,0.249602182,0.491929984
Louisiana,22043,Grant Parish,7925,996,9018,6929,0.87879796,0.110445775,0.768352185
Louisiana,22045,Iberia Parish,19511,9504,29331,10007,0.665200641,0.324025775,0.341174866
Louisiana,22047,Iberville Parish,7616,7503,15354,113,0.496027094,0.488667448,0.007359646
Louisiana,22049,Jackson Parish,5291,1852,7226,3439,0.732216994,0.256296706,0.475920288
Louisiana,22051,Jefferson Parish,98810,75731,178205,23079,0.55447378,0.424965629,0.129508151
Louisiana,22053,Jefferson Davis Parish,11478,2699,14358,8779,0.79941496,0.187978827,0.611436133
Louisiana,22055,Lafayette Parish,72007,37170,111086,34837,0.648209495,0.334605621,0.313603874
Louisiana,22057,Lafourche Parish,34461,7864,42845,26597,0.80431789,0.183545338,0.620772552
Louisiana,22059,LaSalle Parish,6023,546,6620,5477,0.909818731,0.082477341,0.82734139
Louisiana,22061,Lincoln Parish,11248,6627,18157,4621,0.619485598,0.364983202,0.254502396
Louisiana,22063,Livingston Parish,55101,9965,65906,45136,0.83605438,0.151200194,0.684854186
Louisiana,22065,Madison Parish,1846,2094,3992,-248,0.46242485,0.524549098,-0.062124248
Louisiana,22067,Morehouse Parish,5961,4008,10097,1953,0.590373378,0.396949589,0.193423789
Louisiana,22069,Natchitoches Parish,9100,5740,15040,3360,0.605053191,0.381648936,0.223404255
Louisiana,22071,Orleans Parish,24119,130749,159130,-106630,0.1515679,0.821648966,-0.670081066
Louisiana,22073,Ouachita Parish,40808,22845,64436,17963,0.633310572,0.354537836,0.278772736
Louisiana,22075,Plaquemines Parish,6803,3023,9945,3780,0.684062343,0.303971845,0.380090498
Louisiana,22077,Pointe Coupee Parish,7319,4132,11570,3187,0.63258427,0.35713051,0.27545376
Louisiana,22079,Rapides Parish,36171,16537,53395,19634,0.67742298,0.309710647,0.367712333
Louisiana,22081,Red River Parish,2337,1321,3725,1016,0.62738255,0.354630872,0.272751678
Louisiana,22083,Richland Parish,6354,2732,9193,3622,0.69117807,0.297182639,0.393995431
Louisiana,22085,Sabine Parish,8613,1488,10170,7125,0.846902655,0.146312684,0.700589971
Louisiana,22087,St. Bernard Parish,11033,5967,17292,5066,0.638040712,0.345072866,0.292967846
Louisiana,22089,St. Charles Parish,17443,8812,26685,8631,0.653663107,0.330222972,0.323440135
Louisiana,22091,St. Helena Parish,2804,2848,5745,-44,0.488076588,0.495735422,-0.007658834
Louisiana,22093,St. James Parish,5902,5792,11789,110,0.500636186,0.491305454,0.009330732
Louisiana,22095,St. John the Baptist Parish,6557,12043,18827,-5486,0.348276412,0.639666437,-0.291390025
Louisiana,22097,St. Landry Parish,21812,14833,37043,6979,0.588829198,0.400426531,0.188402667
Louisiana,22099,St. Martin Parish,17466,7284,25006,10182,0.698472367,0.29129009,0.407182276
Louisiana,22101,St. Mary Parish,13671,7011,20897,6660,0.654208738,0.335502704,0.318706034
Louisiana,22103,St. Tammany Parish,98377,37777,138384,60600,0.710898659,0.272986761,0.437911897
Louisiana,22105,Tangipahoa Parish,37500,16886,55104,20614,0.680531359,0.306438734,0.374092625
Louisiana,22107,Tensas Parish,1093,1002,2128,91,0.51362782,0.470864662,0.042763158
Louisiana,22109,Terrebonne Parish,31115,9702,41327,21413,0.752897621,0.234761778,0.518135843
Louisiana,22111,Union Parish,8176,2206,10475,5970,0.78052506,0.210596659,0.569928401
Louisiana,22113,Vermilion Parish,21510,4637,26429,16873,0.813878694,0.175451209,0.638427485
Louisiana,22115,Vernon Parish,13474,2513,16149,10961,0.834355068,0.155613351,0.678741718
Louisiana,22117,Washington Parish,12846,5411,18455,7435,0.696071525,0.293199675,0.40287185
Louisiana,22119,Webster Parish,10965,5053,16205,5912,0.676643011,0.31181734,0.364825671
Louisiana,22121,West Baton Rouge Parish,7627,6008,13836,1619,0.551243134,0.434229546,0.117013588
Louisiana,22123,West Carroll Parish,3986,578,4603,3408,0.865956985,0.12557028,0.740386704
Louisiana,22125,West Feliciana Parish,3923,2004,6008,1919,0.652962716,0.33355526,0.319407457
Louisiana,22127,Winn Parish,4437,1292,5781,3145,0.767514271,0.223490746,0.544023525
Maine,23001,Androscoggin County,30605,27019,58847,3586,0.520077489,0.459139803,0.060937686
Maine,23003,Aroostook County,22246,12900,35653,9346,0.623958713,0.361820885,0.262137829
Maine,23005,Cumberland County,60950,133281,199225,-72331,0.3059355,0.668997365,-0.363061865
Maine,23007,Franklin County,9459,7990,17836,1469,0.530331913,0.447970397,0.082361516
Maine,23009,Hancock County,15549,19817,36251,-4268,0.428926099,0.546660782,-0.117734683
Maine,23011,Kennebec County,36589,34585,72886,2004,0.502003128,0.474508136,0.027494992
Maine,23013,Knox County,10262,15076,25893,-4814,0.396323331,0.582242305,-0.185918974
Maine,23015,Lincoln County,10409,13110,24003,-2701,0.433654127,0.546181727,-0.112527601
Maine,23017,Oxford County,19228,14765,34590,4463,0.555883203,0.426857473,0.12902573
Maine,23019,Penobscot County,47438,37945,87073,9493,0.544807231,0.435783768,0.109023463
Maine,23021,Piscataquis County,6487,3510,10205,2977,0.63566879,0.343949045,0.291719745
Maine,23023,Sagadahoc County,9917,13982,24456,-4065,0.405503762,0.571720641,-0.166216879
Maine,23025,Somerset County,17826,10134,28441,7692,0.626771211,0.356316585,0.270454625
Maine,23027,Waldo County,11815,12661,25130,-846,0.470155193,0.503820135,-0.033664942
Maine,23029,Washington County,11003,6763,18048,4240,0.609652039,0.374722961,0.234929078
Maine,23031,York County,58194,72114,132838,-13920,0.438082476,0.542871769,-0.104789292
Maryland,24001,Allegany County,22141,9231,32001,12910,0.691884629,0.288459736,0.403424893
Maryland,24003,Anne Arundel County,128892,171945,308782,-43053,0.417420705,0.556849169,-0.139428464
Maryland,24005,Baltimore County,149560,249958,409811,-100398,0.36494872,0.609934824,-0.244986103
Maryland,24009,Calvert County,29361,23438,53882,5923,0.544912958,0.434987565,0.109925393
Maryland,24011,Caroline County,11053,4860,16276,6193,0.679098058,0.298599164,0.380498894
Maryland,24013,Carroll County,62273,36867,101796,25406,0.611743094,0.362165507,0.249577587
Maryland,24015,Cecil County,33871,17628,52612,16243,0.643788489,0.335056641,0.308731848
Maryland,24017,Charles County,26145,63454,91650,-37309,0.285270049,0.692351337,-0.407081288
Maryland,24019,Dorchester County,9390,6954,16730,2436,0.561267185,0.41566049,0.145606695
Maryland,24021,Frederick County,68753,82409,155004,-13656,0.443556295,0.531657248,-0.088100952
Maryland,24023,Garrett County,11983,3456,15785,8527,0.759138423,0.218942034,0.540196389
Maryland,24025,Harford County,83050,62453,149020,20597,0.557307744,0.419091397,0.138216347
Maryland,24027,Howard County,49425,124764,180488,-75339,0.27384092,0.691259253,-0.417418333
Maryland,24029,Kent County,5561,5251,11068,310,0.502439465,0.474430791,0.028008674
Maryland,24031,Montgomery County,112637,386581,513919,-273944,0.219172671,0.752221654,-0.533048982
Maryland,24033,Prince George's County,45008,347038,401881,-302030,0.111993351,0.86353423,-0.751540879
Maryland,24035,Queen Anne's County,20200,11273,32136,8927,0.628578541,0.350790391,0.27778815
Maryland,24037,St. Mary's County,33582,23531,58543,10051,0.57362964,0.40194387,0.171685769
Maryland,24039,Somerset County,5805,4054,10090,1751,0.575322101,0.401783944,0.173538157
Maryland,24041,Talbot County,11125,11119,22667,6,0.490801606,0.490536904,0.000264702
Maryland,24043,Washington County,44054,27260,73001,16794,0.603471185,0.373419542,0.230051643
Maryland,24045,Wicomico County,24065,21513,46698,2552,0.515332562,0.460683541,0.054649021
Maryland,24047,Worcester County,19632,12431,32728,7201,0.599853337,0.37982767,0.220025666
Maryland,24510,Baltimore city,27984,195109,229082,-167125,0.122157132,0.851699391,-0.72954226
Massachusetts,25001,Barnstable County,57451,88129,147848,-30678,0.388581516,0.596078405,-0.207496889
Massachusetts,25003,Berkshire County,19805,47094,68341,-27289,0.289796755,0.689103174,-0.399306419
Massachusetts,25005,Bristol County,134201,137813,276910,-3612,0.484637608,0.497681557,-0.013043949
Massachusetts,25007,Dukes County,2745,9137,12149,-6392,0.225944522,0.75207836,-0.526133838
Massachusetts,25009,Essex County,155336,236624,399719,-81288,0.388613001,0.591975863,-0.203362862
Massachusetts,25011,Franklin County,12428,28305,42054,-15877,0.295524801,0.673063204,-0.377538403
Massachusetts,25013,Hampden County,92474,110937,207747,-18463,0.445127968,0.534000491,-0.088872523
Massachusetts,25015,Hampshire County,23256,58617,84345,-35361,0.275724702,0.694967099,-0.419242397
Massachusetts,25017,Middlesex County,235118,554471,809513,-319353,0.290443761,0.684943911,-0.39450015
Massachusetts,25019,Nantucket County,2171,4784,7082,-2613,0.306551822,0.675515391,-0.36896357
Massachusetts,25021,Norfolk County,132497,242712,383258,-110215,0.345712288,0.633286194,-0.287573906
Massachusetts,25023,Plymouth County,133544,159962,298682,-26418,0.447110974,0.535559558,-0.088448584
Massachusetts,25025,Suffolk County,66480,222280,297041,-155800,0.223807488,0.748314206,-0.524506718
Massachusetts,25027,Worcester County,183802,225680,418748,-41878,0.438932246,0.538939887,-0.100007642
Michigan,26001,Alcona County,5257,2140,7481,3117,0.702713541,0.286058014,0.416655527
Michigan,26003,Alger County,3116,2075,5258,1041,0.592620768,0.394636744,0.197984024
Michigan,26005,Allegan County,45206,25637,71890,19569,0.628821811,0.356614272,0.272207539
Michigan,26007,Alpena County,10967,6038,17210,4929,0.637245787,0.350842533,0.286403254
Michigan,26009,Antrim County,10341,6330,16882,4011,0.612545907,0.374955574,0.237590333
Michigan,26011,Arenac County,6379,2662,9158,3717,0.696549465,0.29067482,0.405874645
Michigan,26013,Baraga County,2779,1488,4332,1291,0.641505078,0.343490305,0.298014774
Michigan,26015,Barry County,25650,12391,38621,13259,0.664146449,0.320835815,0.343310634
Michigan,26017,Bay County,34792,25767,61331,9025,0.567282451,0.420130114,0.147152337
Michigan,26019,Benzie County,6895,5780,12845,1115,0.536784741,0.449980537,0.086804204
Michigan,26021,Berrien County,44975,38323,84478,6652,0.53238713,0.453644736,0.078742394
Michigan,26023,Branch County,14848,5911,21088,8937,0.704097117,0.280301593,0.423795524
Michigan,26025,Calhoun County,38606,28988,68490,9618,0.563673529,0.423244269,0.14042926
Michigan,26027,Cass County,18505,9050,27869,9455,0.663999426,0.324733575,0.339265851
Michigan,26029,Charlevoix County,10183,7197,17659,2986,0.576646469,0.407554222,0.169092248
Michigan,26031,Cheboygan County,10653,5543,16423,5110,0.64866346,0.337514461,0.311148998
Michigan,26033,Chippewa County,11249,6796,18363,4453,0.612590535,0.370092033,0.242498502
Michigan,26035,Clare County,11772,5273,17288,6499,0.680934752,0.305009255,0.375925497
Michigan,26037,Clinton County,26751,22450,49961,4301,0.535437641,0.449350493,0.086087148
Michigan,26039,Crawford County,5613,2752,8476,2861,0.662222747,0.324681454,0.337541293
Michigan,26041,Delta County,14109,7462,21874,6647,0.645012343,0.341135595,0.303876749
Michigan,26043,Dickinson County,10324,4763,15311,5561,0.674286461,0.311083535,0.363202926
Michigan,26045,Eaton County,33102,31056,65171,2046,0.507925304,0.476530972,0.031394332
Michigan,26047,Emmet County,12465,10005,22848,2460,0.545561975,0.437893908,0.107668067
Michigan,26049,Genesee County,105303,114670,223203,-9367,0.471781293,0.513747575,-0.041966282
Michigan,26051,Gladwin County,10809,4501,15488,6308,0.697895145,0.290612087,0.407283058
Michigan,26053,Gogebic County,4803,3385,8292,1418,0.579232996,0.408224795,0.171008201
Michigan,26055,Grand Traverse County,31423,30339,62760,1084,0.50068515,0.483413002,0.017272148
Michigan,26057,Gratiot County,12894,6682,19848,6212,0.649637243,0.336658605,0.312978638
Michigan,26059,Hillsdale County,18631,5875,24813,12756,0.750856406,0.236771047,0.514085358
Michigan,26061,Houghton County,11181,7881,19364,3300,0.577411692,0.406992357,0.170419335
Michigan,26063,Huron County,13224,5522,18969,7702,0.697137435,0.291106542,0.406030893
Michigan,26065,Ingham County,50564,94542,148012,-43978,0.34162095,0.638745507,-0.297124557
Michigan,26067,Ionia County,22179,11338,34013,10841,0.652074207,0.333343134,0.318731073
Michigan,26069,Iosco County,10155,5344,15731,4811,0.645540652,0.339711398,0.305829254
Michigan,26071,Iron County,4501,2441,7027,2060,0.640529387,0.347374413,0.293154974
Michigan,26073,Isabella County,16320,14011,30817,2309,0.52957783,0.454651653,0.074926177
Michigan,26075,Jackson County,50199,32348,83803,17851,0.599011969,0.386000501,0.213011467
Michigan,26077,Kalamazoo County,58671,84501,145646,-25830,0.402832896,0.580180712,-0.177347816
Michigan,26079,Kalkaska County,8149,3206,11529,4943,0.706826264,0.27808136,0.428744904
Michigan,26081,Kent County,172720,192668,371722,-19948,0.464648312,0.518312072,-0.053663759
Michigan,26083,Keweenaw County,896,690,1611,206,0.556176288,0.4283054,0.127870888
Michigan,26085,Lake County,4523,2298,6915,2225,0.654085322,0.332321041,0.321764281
Michigan,26087,Lapeer County,38398,16338,55435,22060,0.692667088,0.29472355,0.397943537
Michigan,26089,Leelanau County,8035,9406,17680,-1371,0.454468326,0.532013575,-0.077545249
Michigan,26091,Lenawee County,33463,20787,55012,12676,0.608285465,0.377863012,0.230422453
Michigan,26093,Livingston County,81217,49503,132402,31714,0.613412184,0.37388408,0.239528104
Michigan,26095,Luce County,2170,769,2985,1401,0.726968174,0.257621441,0.469346734
Michigan,26097,Mackinac County,4476,2675,7238,1801,0.618402874,0.369577231,0.248825642
Michigan,26099,Macomb County,284660,214977,509056,69683,0.559191916,0.422305208,0.136886708
Michigan,26101,Manistee County,8748,6309,15296,2439,0.571914226,0.412460774,0.159453452
Michigan,26103,Marquette County,17459,20866,38992,-3407,0.447758515,0.535135412,-0.087376898
Michigan,26105,Mason County,10830,6973,18056,3857,0.59980062,0.386187417,0.213613203
Michigan,26107,Mecosta County,14445,7688,22489,6757,0.64231402,0.341856018,0.300458002
Michigan,26109,Menominee County,8647,4256,13060,4391,0.662098009,0.325880551,0.336217458
Michigan,26111,Midland County,28571,20926,50287,7645,0.568158769,0.416131406,0.152027363
Michigan,26113,Missaukee County,7066,1945,9151,5121,0.772156049,0.212545077,0.559610971
Michigan,26115,Monroe County,57405,32622,91338,24783,0.628489785,0.357156934,0.271332852
Michigan,26117,Montcalm County,23946,10368,34835,13578,0.687412086,0.297631692,0.389780393
Michigan,26119,Montmorency County,4599,1702,6391,2897,0.719605696,0.266312001,0.453293694
Michigan,26121,Muskegon County,47733,46028,95160,1705,0.501607818,0.483690626,0.017917192
Michigan,26123,Newaygo County,20630,8131,29197,12499,0.706579443,0.278487516,0.428091927
Michigan,26125,Oakland County,337791,419519,771939,-81728,0.437587685,0.543461336,-0.105873651
Michigan,26127,Oceana County,9547,5085,14870,4462,0.642030935,0.341963685,0.300067249
Michigan,26129,Ogemaw County,8879,3578,12620,5301,0.703565769,0.283518225,0.420047544
Michigan,26131,Ontonagon County,2479,1313,3841,1166,0.645404842,0.341838063,0.303566779
Michigan,26133,Osceola County,9639,3326,13184,6313,0.731113471,0.252275485,0.478837985
Michigan,26135,Oscoda County,3716,1414,5192,2302,0.715716487,0.272342065,0.443374422
Michigan,26137,Otsego County,10693,5052,15971,5641,0.669526016,0.316323336,0.35320268
Michigan,26139,Ottawa County,106133,69653,178402,36480,0.59490925,0.390427237,0.204482013
Michigan,26141,Presque Isle County,5568,3036,8739,2532,0.637143838,0.34740817,0.289735668
Michigan,26143,Roscommon County,10582,5290,16065,5292,0.658699035,0.32928727,0.329411765
Michigan,26145,Saginaw County,52912,49515,103838,3397,0.509562973,0.476848553,0.032714421
Michigan,26147,St. Clair County,64277,30844,96519,33433,0.665951782,0.319564024,0.346387758
Michigan,26149,St. Joseph County,19403,9452,29307,9951,0.662060259,0.322516805,0.339543454
Michigan,26151,Sanilac County,17080,5957,23339,11123,0.731822272,0.255238014,0.476584258
Michigan,26153,Schoolcraft County,3196,1631,4897,1565,0.652644476,0.333061058,0.319583418
Michigan,26155,Shiawassee County,24718,15335,40682,9383,0.607590581,0.376948036,0.230642545
Michigan,26157,Tuscola County,21764,8562,30716,13202,0.708555802,0.278747233,0.429808569
Michigan,26159,Van Buren County,23407,17175,41162,6232,0.568655556,0.417253778,0.151401778
Michigan,26161,Washtenaw County,58844,157152,221304,-98308,0.265896685,0.710118208,-0.444221523
Michigan,26163,Wayne County,288860,537032,856511,-248172,0.337251944,0.626999536,-0.289747592
Michigan,26165,Wexford County,12968,6224,19476,6744,0.665845143,0.319572808,0.346272335
Minnesota,27001,Aitkin County,6741,3524,10419,3217,0.646991074,0.338228237,0.308762837
Minnesota,27003,Anoka County,106974,97667,209656,9307,0.510235815,0.465844049,0.044391766
Minnesota,27005,Becker County,12961,6435,19696,6526,0.658052396,0.326716084,0.331336312
Minnesota,27007,Beltrami County,12898,11493,24807,1405,0.51993389,0.46329665,0.056637239
Minnesota,27009,Benton County,15260,7084,22763,8176,0.670386153,0.311206783,0.35917937
Minnesota,27011,Big Stone County,1796,964,2816,832,0.637784091,0.342329545,0.295454545
Minnesota,27013,Blue Earth County,18001,17558,36326,443,0.495540384,0.483345262,0.012195122
Minnesota,27015,Brown County,9692,4576,14526,5116,0.667217403,0.315021341,0.352196062
Minnesota,27017,Carlton County,10435,9905,20746,530,0.502988528,0.477441434,0.025547093
Minnesota,27019,Carver County,35586,31869,68804,3717,0.517208302,0.46318528,0.054023022
Minnesota,27021,Cass County,12759,6300,19316,6459,0.660540485,0.326154483,0.334386001
Minnesota,27023,Chippewa County,4175,2026,6300,2149,0.662698413,0.321587302,0.341111111
Minnesota,27025,Chisago County,23047,11894,35502,11153,0.649174694,0.335023379,0.314151315
Minnesota,27027,Clay County,15965,16121,32734,-156,0.487719191,0.492484878,-0.004765687
Minnesota,27029,Clearwater County,3575,1169,4805,2406,0.744016649,0.243288241,0.500728408
Minnesota,27031,Cook County,1142,2416,3641,-1274,0.313650096,0.663553969,-0.349903873
Minnesota,27033,Cottonwood County,4157,1705,5965,2452,0.696898575,0.285834032,0.411064543
Minnesota,27035,Crow Wing County,27423,14173,42212,13250,0.649649389,0.335757604,0.313891784
Minnesota,27037,Dakota County,109995,143267,258590,-33272,0.425364477,0.554031478,-0.128667002
Minnesota,27039,Dodge County,8095,4108,12448,3987,0.65030527,0.330012853,0.320292416
Minnesota,27041,Douglas County,16726,7938,25019,8788,0.668531916,0.317278868,0.351253048
Minnesota,27043,Faribault County,5247,2352,7739,2895,0.677994573,0.303915235,0.374079338
Minnesota,27045,Fillmore County,7638,4491,12335,3147,0.61921362,0.364085934,0.255127685
Minnesota,27047,Freeborn County,10003,6448,16670,3555,0.600059988,0.386802639,0.213257349
Minnesota,27049,Goodhue County,16461,11731,28746,4730,0.572636193,0.408091561,0.164544632
Minnesota,27051,Grant County,2266,1187,3531,1079,0.641744548,0.336165392,0.305579156
Minnesota,27053,Hennepin County,197244,502710,716591,-305466,0.275253248,0.701529882,-0.426276635
Minnesota,27055,Houston County,6547,4667,11394,1880,0.574600667,0.409601545,0.164999122
Minnesota,27057,Hubbard County,8809,4536,13570,4273,0.649152542,0.334266765,0.314885777
Minnesota,27059,Isanti County,18027,7384,25829,10643,0.697936428,0.285880212,0.412056216
Minnesota,27061,Itasca County,15863,10467,26760,5396,0.592787743,0.391143498,0.201644245
Minnesota,27063,Jackson County,3949,1581,5625,2368,0.702044444,0.281066667,0.420977778
Minnesota,27065,Kanabec County,6818,2718,9682,4100,0.704193348,0.280727122,0.423466226
Minnesota,27067,Kandiyohi County,15014,7814,23213,7200,0.646792745,0.336621721,0.310171025
Minnesota,27069,Kittson County,1535,911,2495,624,0.615230461,0.365130261,0.2501002
Minnesota,27071,Koochiching County,4204,2465,6776,1739,0.62042503,0.363783943,0.256641086
Minnesota,27073,Lac qui Parle County,2600,1314,3989,1286,0.651792429,0.329405866,0.322386563
Minnesota,27075,Lake County,3265,3534,6929,-269,0.471207967,0.510030307,-0.038822341
Minnesota,27077,Lake of the Woods County,1710,604,2346,1106,0.728900256,0.257459506,0.47144075
Minnesota,27079,Le Sueur County,11503,5636,17422,5867,0.660257146,0.323499024,0.336758122
Minnesota,27081,Lincoln County,2190,972,3226,1218,0.678859268,0.301301922,0.377557347
Minnesota,27083,Lyon County,8400,4284,12946,4116,0.648849065,0.330913023,0.317936042
Minnesota,27085,McLeod County,14394,6374,21131,8020,0.68117931,0.301642137,0.379537173
Minnesota,27087,Mahnomen County,1165,975,2176,190,0.535386029,0.448069853,0.087316176
Minnesota,27089,Marshall County,3774,1177,5024,2597,0.751194268,0.234275478,0.51691879
Minnesota,27091,Martin County,7442,3171,10765,4271,0.691314445,0.294565722,0.396748723
Minnesota,27093,Meeker County,9645,3802,13647,5843,0.706748736,0.278596028,0.428152708
Minnesota,27095,Mille Lacs County,10570,4374,15163,6196,0.697091605,0.288465343,0.408626261
Minnesota,27097,Morrison County,15666,4306,20272,11360,0.772790055,0.212411208,0.560378848
Minnesota,27099,Mower County,10297,8312,18926,1985,0.544066364,0.439184191,0.104882173
Minnesota,27101,Murray County,3346,1329,4755,2017,0.703680336,0.279495268,0.424185068
Minnesota,27103,Nicollet County,9540,9441,19354,99,0.49292136,0.487806138,0.005115222
Minnesota,27105,Nobles County,5541,2599,8258,2942,0.670985711,0.314725115,0.356260596
Minnesota,27107,Norman County,1963,1233,3285,730,0.597564688,0.375342466,0.222222222
Minnesota,27109,Olmsted County,39467,49121,90524,-9654,0.435983827,0.542629579,-0.106645751
Minnesota,27111,Otter Tail County,24276,11752,36608,12524,0.663133741,0.321022727,0.342111014
Minnesota,27113,Pennington County,4756,2439,7361,2317,0.646107866,0.33134085,0.314767015
Minnesota,27115,Pine County,11274,5339,16876,5935,0.668049301,0.316366438,0.351682863
Minnesota,27117,Pipestone County,3537,1215,4828,2322,0.732601491,0.251657001,0.48094449
Minnesota,27119,Polk County,10162,4967,15387,5195,0.660427634,0.322804965,0.337622668
Minnesota,27121,Pope County,4677,2398,7191,2279,0.650396329,0.333472396,0.316923933
Minnesota,27123,Ramsey County,75284,195168,276736,-119884,0.272042669,0.705249769,-0.4332071
Minnesota,27125,Red Lake County,1425,642,2110,783,0.67535545,0.304265403,0.371090047
Minnesota,27127,Redwood County,5895,2300,8299,3595,0.710326545,0.277141824,0.433184721
Minnesota,27129,Renville County,5610,2280,8042,3330,0.697587665,0.283511564,0.4140761
Minnesota,27131,Rice County,18264,17353,36284,911,0.503362364,0.478254878,0.025107485
Minnesota,27133,Rock County,3690,1585,5361,2105,0.688304421,0.295653796,0.392650625
Minnesota,27135,Roseau County,6279,2093,8486,4186,0.739924582,0.246641527,0.493283054
Minnesota,27137,St. Louis County,50065,66335,118587,-16270,0.422179497,0.559378347,-0.13719885
Minnesota,27139,Scott County,47837,40214,89806,7623,0.532670423,0.447787453,0.08488297
Minnesota,27141,Sherburne County,38491,18329,57777,20162,0.666199353,0.317236963,0.34896239
Minnesota,27143,Sibley County,6014,2351,8512,3663,0.706531955,0.276198308,0.430333647
Minnesota,27145,Stearns County,53932,30829,86361,23103,0.624494853,0.356978266,0.267516587
Minnesota,27147,Steele County,12742,7650,20809,5092,0.612331203,0.367629391,0.244701812
Minnesota,27149,Stevens County,3213,1827,5122,1386,0.627294026,0.356696603,0.270597423
Minnesota,27151,Swift County,3340,1618,5041,1722,0.662566951,0.320968062,0.341598889
Minnesota,27153,Todd County,10392,3072,13672,7320,0.760093622,0.224692803,0.535400819
Minnesota,27155,Traverse County,1165,597,1801,568,0.646862854,0.33148251,0.315380344
Minnesota,27157,Wabasha County,8523,4721,13481,3802,0.632223129,0.350196573,0.282026556
Minnesota,27159,Wadena County,6028,1898,8024,4130,0.751246261,0.236540379,0.514705882
Minnesota,27161,Waseca County,6770,3402,10361,3368,0.653411833,0.328346685,0.325065148
Minnesota,27163,Washington County,75271,90324,168743,-15053,0.446068874,0.535275537,-0.089206663
Minnesota,27165,Watonwan County,3087,1723,4910,1364,0.628716904,0.350916497,0.277800407
Minnesota,27167,Wilkin County,2290,986,3343,1304,0.685013461,0.29494466,0.3900688
Minnesota,27169,Winona County,14288,12929,27721,1359,0.515421522,0.466397316,0.049024205
Minnesota,27171,Wright County,57211,30883,89700,26328,0.63780379,0.344292085,0.293511706
Minnesota,27173,Yellow Medicine County,3738,1548,5391,2190,0.693377852,0.287145242,0.40623261
Mississippi,28001,Adams County,5081,6743,11928,-1662,0.425972502,0.565308518,-0.139336016
Mississippi,28003,Alcorn County,12657,2328,15112,10329,0.837546321,0.154049762,0.683496559
Mississippi,28005,Amite County,4484,2246,6815,2238,0.657960382,0.329567131,0.32839325
Mississippi,28007,Attala County,4723,2930,7703,1793,0.613137739,0.380371284,0.232766455
Mississippi,28009,Benton County,2535,1318,3880,1217,0.653350515,0.339690722,0.313659794
Mississippi,28011,Bolivar County,3943,6419,10435,-2476,0.377862961,0.615141351,-0.23727839
Mississippi,28013,Calhoun County,4443,1547,6034,2896,0.736327478,0.25638051,0.479946967
Mississippi,28015,Carroll County,3730,1431,5194,2299,0.718136311,0.275510204,0.442626107
Mississippi,28017,Chickasaw County,4079,3090,7234,989,0.563865082,0.427149571,0.13671551
Mississippi,28019,Choctaw County,2881,965,3890,1916,0.740616967,0.248071979,0.492544987
Mississippi,28021,Claiborne County,558,2950,3541,-2392,0.157582604,0.833097995,-0.675515391
Mississippi,28023,Clarke County,5093,2430,7571,2663,0.672698455,0.320961564,0.351736891
Mississippi,28025,Clay County,4017,4960,9057,-943,0.443524346,0.547642707,-0.104118361
Mississippi,28027,Coahoma County,2008,4711,6790,-2703,0.295729013,0.693814433,-0.39808542
Mississippi,28029,Copiah County,6134,5426,11665,708,0.52584655,0.465152165,0.060694385
Mississippi,28031,Covington County,5869,2921,8861,2948,0.662340594,0.329646767,0.332693827
Mississippi,28033,DeSoto County,48064,29023,79082,19041,0.607774209,0.366998811,0.240775398
Mississippi,28035,Forrest County,16579,11475,28466,5104,0.582414108,0.403112485,0.179301623
Mississippi,28037,Franklin County,2831,1213,4066,1618,0.696261682,0.298327595,0.397934088
Mississippi,28039,George County,9858,1138,11069,8720,0.890595356,0.102809649,0.787785708
Mississippi,28041,Greene County,4776,835,5649,3941,0.845459373,0.147813772,0.697645601
Mississippi,28043,Grenada County,5651,4060,9766,1591,0.57864018,0.415728036,0.162912144
Mississippi,28045,Hancock County,16684,4262,21175,12422,0.787910272,0.201275089,0.586635183
Mississippi,28047,Harrison County,48497,26555,75923,21942,0.638765591,0.349762259,0.289003332
Mississippi,28049,Hinds County,22816,62840,86830,-40024,0.262766325,0.723713002,-0.460946677
Mississippi,28051,Holmes County,1243,5420,6730,-4177,0.184695394,0.805349183,-0.620653789
Mississippi,28053,Humphreys County,990,2443,3468,-1453,0.285467128,0.7044406,-0.418973472
Mississippi,28055,Issaquena County,296,287,622,9,0.475884244,0.461414791,0.014469453
Mississippi,28057,Itawamba County,9523,1027,10621,8496,0.896619904,0.096695226,0.799924678
Mississippi,28059,Jackson County,36376,15469,52410,20907,0.694066018,0.295153597,0.398912421
Mississippi,28061,Jasper County,4118,3722,7890,396,0.521926489,0.471736375,0.050190114
Mississippi,28063,Jefferson County,541,2727,3299,-2186,0.163989088,0.826614125,-0.662625038
Mississippi,28065,Jefferson Davis County,2302,3041,5378,-739,0.428040164,0.565451841,-0.137411677
Mississippi,28067,Jones County,20265,7272,27755,12993,0.730138714,0.262006846,0.468131868
Mississippi,28069,Kemper County,1691,2381,4086,-690,0.413852178,0.582721488,-0.16886931
Mississippi,28071,Lafayette County,14050,8956,23409,5094,0.600196506,0.382587894,0.217608612
Mississippi,28073,Lamar County,20775,7038,28171,13737,0.737460509,0.249831387,0.487629122
Mississippi,28075,Lauderdale County,16487,10677,27407,5810,0.601561645,0.389572007,0.211989638
Mississippi,28077,Lawrence County,4113,1899,6053,2214,0.67949777,0.31372873,0.36576904
Mississippi,28079,Leake County,5143,3182,8380,1961,0.61372315,0.379713604,0.234009547
Mississippi,28081,Lee County,24339,10616,35338,13723,0.688748656,0.300413153,0.388335503
Mississippi,28083,Leflore County,2854,6476,9421,-3622,0.30294024,0.687400488,-0.384460248
Mississippi,28085,Lincoln County,11432,4262,15802,7170,0.723452728,0.269712695,0.453740033
Mississippi,28087,Lowndes County,13087,11096,24426,1991,0.535781544,0.45427004,0.081511504
Mississippi,28089,Madison County,32333,22700,55710,9633,0.580380542,0.407467241,0.172913301
Mississippi,28091,Marion County,7874,3215,11188,4659,0.703789775,0.287361459,0.416428316
Mississippi,28093,Marshall County,7977,6888,14983,1089,0.532403391,0.459721017,0.072682373
Mississippi,28095,Monroe County,10861,5090,16069,5771,0.675897691,0.316758977,0.359138714
Mississippi,28097,Montgomery County,2658,1737,4424,921,0.600813743,0.392631103,0.20818264
Mississippi,28099,Neshoba County,8154,2622,10861,5532,0.750759599,0.241414234,0.509345364
Mississippi,28101,Newton County,6641,2603,9323,4038,0.712324359,0.279201974,0.433122385
Mississippi,28103,Noxubee County,1151,3269,4449,-2118,0.258709822,0.734771859,-0.476062036
Mississippi,28105,Oktibbeha County,8901,8851,18051,50,0.493102875,0.490332946,0.00276993
Mississippi,28107,Panola County,8202,6061,14422,2141,0.568714464,0.420260713,0.148453751
Mississippi,28109,Pearl River County,20438,3982,24671,16456,0.828422034,0.161404078,0.667017956
Mississippi,28111,Perry County,4425,1078,5539,3347,0.798880664,0.194619968,0.604260697
Mississippi,28113,Pike County,7943,7402,15485,541,0.512948014,0.478010978,0.034937036
Mississippi,28115,Pontotoc County,11740,2214,14068,9526,0.834518055,0.157378448,0.677139608
Mississippi,28117,Prentiss County,8581,1727,10381,6854,0.8266063,0.166361622,0.660244678
Mississippi,28119,Quitman County,902,1725,2677,-823,0.336944341,0.644378035,-0.307433694
Mississippi,28121,Rankin County,50896,18060,69678,32836,0.730445765,0.259192285,0.47125348
Mississippi,28123,Scott County,6098,3729,9891,2369,0.616520069,0.377009402,0.239510666
Mississippi,28125,Sharkey County,551,1201,1766,-650,0.31200453,0.68006795,-0.36806342
Mississippi,28127,Simpson County,7552,3479,11094,4073,0.680728322,0.313592933,0.367135388
Mississippi,28129,Smith County,6146,1486,7676,4660,0.800677436,0.193590412,0.607087024
Mississippi,28131,Stone County,6214,1620,7919,4594,0.784695037,0.204571284,0.580123753
Mississippi,28133,Sunflower County,2515,5312,7876,-2797,0.31932453,0.674454038,-0.355129507
Mississippi,28135,Tallahatchie County,2333,2630,5012,-297,0.465482841,0.524740623,-0.059257781
Mississippi,28137,Tate County,9185,3555,12861,5630,0.714174636,0.276417075,0.437757562
Mississippi,28139,Tippah County,7984,1547,9591,6437,0.832447086,0.161297049,0.671150036
Mississippi,28141,Tishomingo County,8064,921,9050,7143,0.891049724,0.101767956,0.789281768
Mississippi,28143,Tunica County,799,1837,2668,-1038,0.299475262,0.688530735,-0.389055472
Mississippi,28145,Union County,10559,1807,12478,8752,0.846209328,0.144814874,0.701394454
Mississippi,28147,Walthall County,4114,2355,6529,1759,0.630111809,0.360698422,0.269413386
Mississippi,28149,Warren County,9407,8683,18298,724,0.514099902,0.474532736,0.039567166
Mississippi,28151,Washington County,4649,9735,14540,-5086,0.319738652,0.669532325,-0.349793673
Mississippi,28153,Wayne County,6013,3028,9119,2985,0.659392477,0.332053953,0.327338524
Mississippi,28155,Webster County,4195,872,5095,3323,0.823356232,0.171148184,0.652208047
Mississippi,28157,Wilkinson County,1075,1817,2931,-742,0.366769021,0.61992494,-0.253155919
Mississippi,28159,Winston County,4922,3392,8384,1530,0.587070611,0.404580153,0.182490458
Mississippi,28161,Yalobusha County,3518,2289,5878,1229,0.598502892,0.389418169,0.209084723
Mississippi,28163,Yazoo County,4558,4342,8971,216,0.508081596,0.484004013,0.024077583
Missouri,29001,Adair County,6771,3334,10234,3437,0.661618136,0.325776822,0.335841313
Missouri,29003,Andrew County,7407,2312,9846,5095,0.752285192,0.234816169,0.517469023
Missouri,29005,Atchison County,2152,529,2713,1623,0.79321784,0.194987099,0.598230741
Missouri,29007,Audrain County,7699,2688,10519,5011,0.73191368,0.255537599,0.476376081
Missouri,29009,Barry County,13138,2873,16160,10265,0.81299505,0.177784653,0.635210396
Missouri,29011,Barton County,5159,820,6014,4339,0.857831726,0.13634852,0.721483206
Missouri,29013,Bates County,6702,1563,8340,5139,0.803597122,0.187410072,0.61618705
Missouri,29015,Benton County,8526,2166,10769,6360,0.791716965,0.201132881,0.590584084
Missouri,29017,Bollinger County,5365,756,6161,4609,0.870800195,0.122707353,0.748092842
Missouri,29019,Boone County,39673,48452,89978,-8779,0.440918891,0.538487186,-0.097568294
Missouri,29021,Buchanan County,22606,12598,35737,10008,0.632565688,0.352519797,0.280045891
Missouri,29023,Butler County,14549,3160,17859,11389,0.814659275,0.176941598,0.637717677
Missouri,29025,Caldwell County,3771,888,4703,2883,0.80182862,0.18881565,0.61301297
Missouri,29027,Callaway County,15206,5926,21447,9280,0.70900359,0.276309041,0.432694549
Missouri,29029,Camden County,19597,5724,25548,13873,0.767065915,0.224048849,0.543017066
Missouri,29031,Cape Girardeau County,29315,10561,40336,18754,0.726770131,0.261825664,0.464944466
Missouri,29033,Carroll County,3708,789,4528,2919,0.818904594,0.174249117,0.644655477
Missouri,29035,Carter County,2488,364,2862,2124,0.869322152,0.127183788,0.742138365
Missouri,29037,Cass County,38792,19753,59327,19039,0.653867548,0.33295127,0.320916278
Missouri,29039,Cedar County,6064,1060,7187,5004,0.843745652,0.147488521,0.696257131
Missouri,29041,Chariton County,3179,875,4088,2304,0.777641879,0.214041096,0.563600783
Missouri,29043,Christian County,38379,11850,50770,26529,0.755938546,0.233405554,0.522532992
Missouri,29045,Clark County,2679,628,3333,2051,0.803780378,0.188418842,0.615361536
Missouri,29047,Clay County,67688,60345,130063,7343,0.520424717,0.463967462,0.056457255
Missouri,29049,Clinton County,8235,2855,11228,5380,0.733434271,0.254275027,0.479159245
Missouri,29051,Cole County,26686,12874,40128,13812,0.66502193,0.320823365,0.344198565
Missouri,29053,Cooper County,6393,2347,8833,4046,0.723763161,0.26570814,0.458055021
Missouri,29055,Crawford County,8742,2007,10829,6735,0.807276757,0.185335673,0.621941084
Missouri,29057,Dade County,3480,671,4185,2809,0.831541219,0.160334528,0.671206691
Missouri,29059,Dallas County,6907,1458,8440,5449,0.818364929,0.172748815,0.645616114
Missouri,29061,Daviess County,3185,701,3925,2484,0.811464968,0.178598726,0.632866242
Missouri,29063,DeKalb County,3885,870,4814,3015,0.807021188,0.180722892,0.626298297
Missouri,29065,Dent County,6013,1025,7103,4988,0.846543714,0.144305223,0.702238491
Missouri,29067,Douglas County,6242,996,7289,5246,0.856358897,0.136644258,0.719714638
Missouri,29069,Dunklin County,8096,1885,10051,6211,0.805491991,0.187543528,0.617948463
Missouri,29071,Franklin County,40126,14694,55454,25432,0.723590724,0.264976377,0.458614347
Missouri,29073,Gasconade County,6370,1555,7996,4815,0.796648324,0.194472236,0.602176088
Missouri,29075,Gentry County,2651,616,3292,2035,0.805285541,0.187120292,0.618165249
Missouri,29077,Greene County,85956,55971,143935,29985,0.59718623,0.388863028,0.208323201
Missouri,29079,Grundy County,3582,784,4400,2798,0.814090909,0.178181818,0.635909091
Missouri,29081,Harrison County,3293,534,3845,2759,0.856436931,0.138881664,0.717555267
Missouri,29083,Henry County,8286,2535,10932,5751,0.757958288,0.231888035,0.526070252
Missouri,29085,Hickory County,4108,978,5120,3130,0.80234375,0.191015625,0.611328125
Missouri,29087,Holt County,1982,357,2352,1625,0.842687075,0.151785714,0.690901361
Missouri,29089,Howard County,3534,1341,4955,2193,0.713218971,0.270635721,0.442583249
Missouri,29091,Howell County,15733,3073,18963,12660,0.829668301,0.162052418,0.667615884
Missouri,29093,Iron County,3644,824,4517,2820,0.806730131,0.182421961,0.624308169
Missouri,29095,Jackson County,125610,187026,317702,-61416,0.395370504,0.588683735,-0.193313231
Missouri,29097,Jasper County,39084,13943,53756,25141,0.727063026,0.259375698,0.467687328
Missouri,29099,Jefferson County,80796,36965,119287,43831,0.677324436,0.309882887,0.367441549
Missouri,29101,Johnson County,16298,6960,23591,9338,0.690856683,0.295027765,0.395828918
Missouri,29103,Knox County,1479,311,1810,1168,0.817127072,0.171823204,0.645303867
Missouri,29105,Laclede County,14155,2756,17076,11399,0.828941204,0.161396112,0.667545093
Missouri,29107,Lafayette County,12720,4294,17244,8426,0.737647878,0.24901415,0.488633728
Missouri,29109,Lawrence County,15001,3248,18417,11753,0.814519194,0.176358799,0.638160395
Missouri,29111,Lewis County,3565,872,4484,2693,0.795049063,0.194469224,0.600579839
Missouri,29113,Lincoln County,24866,6908,32129,17958,0.773942544,0.215008248,0.558934296
Missouri,29115,Linn County,4437,1183,5684,3254,0.780612245,0.208128079,0.572484166
Missouri,29117,Livingston County,5395,1422,6871,3973,0.785184107,0.206956775,0.578227332
Missouri,29119,McDonald County,7843,1423,9338,6420,0.839901478,0.152388092,0.687513386
Missouri,29121,Macon County,6300,1481,7838,4819,0.803776474,0.188951263,0.614825211
Missouri,29123,Madison County,4721,986,5753,3735,0.820615331,0.171388841,0.649226491
Missouri,29125,Maries County,3987,755,4786,3232,0.833054743,0.157751776,0.675302967
Missouri,29127,Marion County,9991,3032,13148,6959,0.759887435,0.230605415,0.52928202
Missouri,29129,Mercer County,1545,235,1792,1310,0.862165179,0.131138393,0.731026786
Missouri,29131,Miller County,10826,2067,13009,8759,0.832193097,0.158889999,0.673303098
Missouri,29133,Mississippi County,3404,1015,4449,2389,0.765115756,0.228141155,0.536974601
Missouri,29135,Moniteau County,5877,1313,7273,4564,0.808057198,0.18053073,0.627526468
Missouri,29137,Monroe County,3476,857,4376,2619,0.794332724,0.195840951,0.598491773
Missouri,29139,Montgomery County,4776,1170,5996,3606,0.796531021,0.195130087,0.601400934
Missouri,29141,Morgan County,7725,1914,9733,5811,0.793691565,0.19665057,0.597040995
Missouri,29143,New Madrid County,5203,1561,6811,3642,0.76391132,0.229188078,0.534723242
Missouri,29145,Newton County,22923,5867,29083,17056,0.788192415,0.201732971,0.586459444
Missouri,29147,Nodaway County,6909,2674,9682,4235,0.713592233,0.276182607,0.437409626
Missouri,29149,Oregon County,3884,696,4612,3188,0.842150911,0.150910668,0.691240243
Missouri,29151,Osage County,6657,1009,7725,5648,0.861747573,0.130614887,0.731132686
Missouri,29153,Ozark County,4044,698,4779,3346,0.846202134,0.14605566,0.700146474
Missouri,29155,Pemiscot County,3917,1331,5270,2586,0.743263757,0.25256167,0.490702087
Missouri,29157,Perry County,7986,1757,9823,6229,0.812989922,0.178865927,0.634123995
Missouri,29159,Pettis County,13907,4703,18877,9204,0.736716639,0.249139164,0.487577475
Missouri,29161,Phelps County,13658,5379,19294,8279,0.707888463,0.278791334,0.429097129
Missouri,29163,Pike County,6151,1618,7824,4533,0.786170757,0.206799591,0.579371166
Missouri,29165,Platte County,29381,27566,57787,1815,0.508436153,0.477027705,0.031408448
Missouri,29167,Polk County,12691,2948,15817,9743,0.802364544,0.186381741,0.615982803
Missouri,29169,Pulaski County,11579,3765,15545,7814,0.744869733,0.242200064,0.502669669
Missouri,29171,Putnam County,2021,347,2380,1674,0.849159664,0.145798319,0.703361345
Missouri,29173,Ralls County,4575,1154,5777,3421,0.79193353,0.19975766,0.59217587
Missouri,29175,Randolph County,8322,2571,11025,5751,0.754829932,0.233197279,0.521632653
Missouri,29177,Ray County,8602,2927,11662,5675,0.737609329,0.250986109,0.486623221
Missouri,29179,Reynolds County,2560,472,3057,2088,0.837422309,0.154399738,0.683022571
Missouri,29181,Ripley County,5002,763,5804,4239,0.861819435,0.131461061,0.730358374
Missouri,29183,St. Charles County,130588,92226,226052,38362,0.577690089,0.407985773,0.169704316
Missouri,29185,St. Clair County,3982,959,4987,3023,0.798476038,0.19229998,0.606176058
Missouri,29186,Ste. Genevieve County,7031,2629,9775,4402,0.719283887,0.268951407,0.450332481
Missouri,29187,St. Francois County,21521,6811,28614,14710,0.75211435,0.238030335,0.514084015
Missouri,29189,St. Louis County,187982,305635,502356,-117653,0.374200766,0.608403204,-0.234202438
Missouri,29195,Saline County,6498,2726,9330,3772,0.696463023,0.292175777,0.404287245
Missouri,29197,Schuyler County,1588,334,1945,1254,0.816452442,0.171722365,0.644730077
Missouri,29199,Scotland County,1537,358,1918,1179,0.801355579,0.186652763,0.614702815
Missouri,29201,Scott County,13786,3525,17418,10261,0.791480078,0.202376852,0.589103227
Missouri,29203,Shannon County,3364,625,4013,2739,0.838275604,0.155743833,0.682531772
Missouri,29205,Shelby County,2691,550,3262,2141,0.824954016,0.168608216,0.6563458
Missouri,29207,Stoddard County,11783,1736,13599,10047,0.866460769,0.127656445,0.738804324
Missouri,29209,Stone County,15357,3620,19122,11737,0.80310637,0.189310742,0.613795628
Missouri,29211,Sullivan County,2035,408,2463,1627,0.826228177,0.165651644,0.660576533
Missouri,29213,Taney County,21236,5329,26811,15907,0.792062959,0.198761702,0.593301257
Missouri,29215,Texas County,9855,1589,11525,8266,0.855097614,0.137874187,0.717223427
Missouri,29217,Vernon County,7112,1774,8973,5338,0.792600022,0.197704224,0.594895799
Missouri,29219,Warren County,14915,4970,20094,9945,0.742261372,0.247337514,0.494923858
Missouri,29221,Washington County,8424,1747,10235,6677,0.823058134,0.170688813,0.652369321
Missouri,29223,Wayne County,5030,783,5847,4247,0.860270224,0.133914828,0.726355396
Missouri,29225,Webster County,15984,3653,19808,12331,0.806946688,0.184420436,0.622526252
Missouri,29227,Worth County,904,190,1105,714,0.818099548,0.171945701,0.646153846
Missouri,29229,Wright County,7850,1057,8978,6793,0.874359546,0.117732234,0.756627311
Missouri,29510,St. Louis city,19342,94458,116082,-75116,0.166623594,0.813717889,-0.647094295
Montana,30001,Beaverhead County,4058,1543,5794,2515,0.700379703,0.266309976,0.434069727
Montana,30003,Big Horn County,2188,2112,4470,76,0.489485459,0.472483221,0.017002237
Montana,30005,Blaine County,1526,1348,3019,178,0.505465386,0.446505465,0.058959921
Montana,30007,Broadwater County,3770,885,4810,2885,0.783783784,0.183991684,0.5997921
Montana,30009,Carbon County,4719,2353,7297,2366,0.646704125,0.322461285,0.32424284
Montana,30011,Carter County,760,75,854,685,0.889929742,0.087822014,0.802107728
Montana,30013,Cascade County,22419,14021,37583,8398,0.596519703,0.37306761,0.223452093
Montana,30015,Chouteau County,1885,940,2934,945,0.642467621,0.320381731,0.32208589
Montana,30017,Custer County,4208,1385,5797,2823,0.725892703,0.238916681,0.486976022
Montana,30019,Daniels County,778,154,951,624,0.818086225,0.161934805,0.65615142
Montana,30021,Dawson County,3627,894,4638,2733,0.782018111,0.192755498,0.589262613
Montana,30023,Deer Lodge County,2329,2376,4870,-47,0.478234086,0.48788501,-0.009650924
Montana,30025,Fallon County,1303,163,1507,1140,0.864631719,0.108161911,0.756469808
Montana,30027,Fergus County,4965,1522,6712,3443,0.739719905,0.226758045,0.512961859
Montana,30029,Flathead County,41390,20062,63140,21328,0.655527399,0.317738359,0.33778904
Montana,30031,Gallatin County,32695,34938,69897,-2243,0.467759704,0.499849779,-0.032090075
Montana,30033,Garfield County,756,39,800,717,0.945,0.04875,0.89625
Montana,30035,Glacier County,1939,2933,5078,-994,0.381843245,0.577589602,-0.195746357
Montana,30037,Golden Valley County,440,67,515,373,0.854368932,0.130097087,0.724271845
Montana,30039,Granite County,1537,579,2176,958,0.706341912,0.266084559,0.440257353
Montana,30041,Hill County,3871,2634,6804,1237,0.568930041,0.38712522,0.181804821
Montana,30043,Jefferson County,5544,2516,8291,3028,0.668676879,0.303461585,0.365215294
Montana,30045,Judith Basin County,1051,265,1353,786,0.776792313,0.19586105,0.580931264
Montana,30047,Lake County,9880,6510,16910,3370,0.584269663,0.384979302,0.199290361
Montana,30049,Lewis and Clark County,21479,19085,42023,2394,0.51112486,0.454156057,0.056968803
Montana,30051,Liberty County,752,214,988,538,0.761133603,0.21659919,0.544534413
Montana,30053,Lincoln County,8909,2615,11789,6294,0.75570447,0.221816948,0.533887522
Montana,30055,McCone County,931,129,1082,802,0.860443623,0.11922366,0.741219963
Montana,30057,Madison County,4615,1689,6461,2926,0.714285714,0.261414642,0.452871073
Montana,30059,Meagher County,888,256,1172,632,0.757679181,0.218430034,0.539249147
Montana,30061,Mineral County,2049,689,2833,1360,0.72326156,0.243205083,0.480056477
Montana,30063,Missoula County,27306,42903,72773,-15597,0.375221579,0.589545573,-0.214323994
Montana,30065,Musselshell County,2550,396,3012,2154,0.846613546,0.131474104,0.715139442
Montana,30067,Park County,6128,5224,11717,904,0.523000768,0.445847913,0.077152855
Montana,30069,Petroleum County,284,37,324,247,0.87654321,0.114197531,0.762345679
Montana,30071,Phillips County,1753,385,2189,1368,0.800822293,0.175879397,0.624942896
Montana,30073,Pondera County,1972,782,2852,1190,0.6914446,0.274193548,0.417251052
Montana,30075,Powder River County,963,131,1106,832,0.870705244,0.118444846,0.752260398
Montana,30077,Powell County,2466,710,3282,1756,0.751371115,0.216331505,0.53503961
Montana,30079,Prairie County,546,122,688,424,0.793604651,0.177325581,0.61627907
Montana,30081,Ravalli County,20617,8485,29904,12132,0.68943954,0.283741306,0.405698234
Montana,30083,Richland County,4387,778,5309,3609,0.826332643,0.146543605,0.679789037
Montana,30085,Roosevelt County,2055,1680,3914,375,0.525038324,0.429228411,0.095809913
Montana,30087,Rosebud County,2466,1095,3693,1371,0.667749797,0.296506905,0.371242892
Montana,30089,Sanders County,6150,1705,8069,4445,0.76217623,0.211302516,0.550873714
Montana,30091,Sheridan County,1321,509,1912,812,0.690899582,0.266213389,0.424686192
Montana,30093,Silver Bow County,8110,9386,18226,-1276,0.444968726,0.514978602,-0.070009876
Montana,30095,Stillwater County,4699,1056,5906,3643,0.795631561,0.178801219,0.616830342
Montana,30097,Sweet Grass County,1789,525,2381,1264,0.751364973,0.22049559,0.530869383
Montana,30099,Teton County,2533,927,3568,1606,0.709921525,0.259809417,0.450112108
Montana,30101,Toole County,1571,415,2046,1156,0.767839687,0.2028348,0.565004888
Montana,30103,Treasure County,367,57,442,310,0.830316742,0.128959276,0.701357466
Montana,30105,Valley County,3019,935,4079,2084,0.740132385,0.229222849,0.510909537
Montana,30107,Wheatland County,843,209,1086,634,0.776243094,0.192449355,0.583793738
Montana,30109,Wibaux County,463,71,546,392,0.847985348,0.13003663,0.717948718
Montana,30111,Yellowstone County,50460,28392,81391,22068,0.619970267,0.348834638,0.271135629
Nebraska,31001,Adams County,10077,4100,14364,5977,0.70154553,0.285435812,0.416109719
Nebraska,31003,Antelope County,3032,396,3447,2636,0.879605454,0.114882507,0.764722947
Nebraska,31005,Arthur County,264,17,282,247,0.936170213,0.060283688,0.875886525
Nebraska,31007,Banner County,348,34,386,314,0.901554404,0.088082902,0.813471503
Nebraska,31009,Blaine County,250,37,291,213,0.859106529,0.127147766,0.731958763
Nebraska,31011,Boone County,2499,496,3031,2003,0.82448037,0.163642362,0.660838007
Nebraska,31013,Box Butte County,3827,1043,4931,2784,0.776110322,0.211518962,0.564591361
Nebraska,31015,Boyd County,938,132,1075,806,0.87255814,0.122790698,0.749767442
Nebraska,31017,Brown County,1428,201,1642,1227,0.869671133,0.122411693,0.74725944
Nebraska,31019,Buffalo County,17064,6386,23759,10678,0.718212046,0.268782356,0.44942969
Nebraska,31021,Burt County,2632,983,3656,1649,0.719912473,0.268873085,0.451039387
Nebraska,31023,Butler County,3642,906,4587,2736,0.793982995,0.197514716,0.59646828
Nebraska,31025,Cass County,10685,4824,15755,5861,0.678197398,0.306188512,0.372008886
Nebraska,31027,Cedar County,4141,702,4912,3439,0.843037459,0.142915309,0.70012215
Nebraska,31029,Chase County,1648,204,1866,1444,0.883172562,0.109324759,0.773847803
Nebraska,31031,Cherry County,2687,349,3069,2338,0.875529488,0.113717823,0.761811665
Nebraska,31033,Cheyenne County,3692,787,4530,2905,0.815011038,0.173730684,0.641280353
Nebraska,31035,Clay County,2677,577,3310,2100,0.808761329,0.174320242,0.634441088
Nebraska,31037,Colfax County,2636,845,3516,1791,0.749715586,0.24032992,0.509385666
Nebraska,31039,Cuming County,3536,867,4445,2669,0.795500562,0.195050619,0.600449944
Nebraska,31041,Custer County,5042,786,5886,4256,0.856608902,0.133537207,0.723071696
Nebraska,31043,Dakota County,3934,2109,6120,1825,0.642810458,0.344607843,0.298202614
Nebraska,31045,Dawes County,2812,992,3868,1820,0.726990693,0.256463289,0.470527404
Nebraska,31047,Dawson County,6312,2101,8491,4211,0.743375339,0.247438464,0.495936874
Nebraska,31049,Deuel County,843,151,1012,692,0.833003953,0.149209486,0.683794466
Nebraska,31051,Dixon County,2271,573,2895,1698,0.784455959,0.197927461,0.586528497
Nebraska,31053,Dodge County,10795,5434,16443,5361,0.656510369,0.330474974,0.326035395
Nebraska,31055,Douglas County,120919,148733,273403,-27814,0.442273859,0.544006467,-0.101732607
Nebraska,31057,Dundy County,829,96,929,733,0.892357374,0.103336921,0.789020452
Nebraska,31059,Fillmore County,2315,662,3013,1653,0.768337205,0.21971457,0.548622635
Nebraska,31061,Franklin County,1351,236,1600,1115,0.844375,0.1475,0.696875
Nebraska,31063,Frontier County,1213,185,1410,1028,0.860283688,0.131205674,0.729078014
Nebraska,31065,Furnas County,2043,358,2413,1685,0.846663904,0.148363034,0.69830087
Nebraska,31067,Gage County,7523,3242,10916,4281,0.689171858,0.296995236,0.392176621
Nebraska,31069,Garden County,949,162,1117,787,0.849597135,0.145031334,0.704565801
Nebraska,31071,Garfield County,893,116,1015,777,0.879802956,0.114285714,0.765517241
Nebraska,31073,Gosper County,907,203,1118,704,0.811270125,0.18157424,0.629695886
Nebraska,31075,Grant County,351,15,366,336,0.959016393,0.040983607,0.918032787
Nebraska,31077,Greeley County,1030,192,1235,838,0.834008097,0.155465587,0.67854251
Nebraska,31079,Hall County,15566,6956,22804,8610,0.682599544,0.305034205,0.377565339
Nebraska,31081,Hamilton County,4416,1067,5547,3349,0.796106003,0.192356229,0.603749775
Nebraska,31083,Harlan County,1506,280,1802,1226,0.835738069,0.155382908,0.680355161
Nebraska,31085,Hayes County,472,19,494,453,0.955465587,0.038461538,0.917004049
Nebraska,31087,Hitchcock County,1269,152,1433,1117,0.88555478,0.106071179,0.779483601
Nebraska,31089,Holt County,4708,681,5442,4027,0.865123117,0.125137817,0.7399853
Nebraska,31091,Hooker County,369,55,427,314,0.864168618,0.128805621,0.735362998
Nebraska,31093,Howard County,2868,642,3550,2226,0.807887324,0.18084507,0.627042254
Nebraska,31095,Jefferson County,2614,968,3631,1646,0.71991187,0.266593225,0.453318645
Nebraska,31097,Johnson County,1496,625,2152,871,0.695167286,0.290427509,0.404739777
Nebraska,31099,Kearney County,2828,736,3604,2092,0.784683685,0.204217536,0.580466149
Nebraska,31101,Keith County,3416,731,4199,2685,0.81352703,0.174089069,0.639437961
Nebraska,31103,Keya Paha County,500,44,544,456,0.919117647,0.080882353,0.838235294
Nebraska,31105,Kimball County,1424,272,1720,1152,0.827906977,0.158139535,0.669767442
Nebraska,31107,Knox County,3593,786,4436,2807,0.809963931,0.177186655,0.632777277
Nebraska,31109,Lancaster County,74215,81012,157633,-6797,0.470808777,0.513927921,-0.043119144
Nebraska,31111,Lincoln County,12674,3586,16464,9088,0.769800777,0.217808552,0.551992225
Nebraska,31113,Logan County,409,25,440,384,0.929545455,0.056818182,0.872727273
Nebraska,31115,Loup County,354,73,428,281,0.827102804,0.170560748,0.656542056
Nebraska,31117,McPherson County,267,12,283,255,0.943462898,0.042402827,0.901060071
Nebraska,31119,Madison County,12145,3360,15690,8785,0.774059911,0.21414914,0.559910771
Nebraska,31121,Merrick County,3551,730,4342,2821,0.817825887,0.168125288,0.649700599
Nebraska,31123,Morrill County,2026,366,2426,1660,0.835119538,0.150865622,0.684253916
Nebraska,31125,Nance County,1462,352,1837,1110,0.79586282,0.191616766,0.604246053
Nebraska,31127,Nemaha County,2443,915,3418,1528,0.714745465,0.26770041,0.447045056
Nebraska,31129,Nuckolls County,1836,399,2258,1437,0.813108946,0.176705049,0.636403897
Nebraska,31131,Otoe County,5651,2463,8198,3188,0.689314467,0.300439131,0.388875335
Nebraska,31133,Pawnee County,1085,284,1379,801,0.78680203,0.205946338,0.580855693
Nebraska,31135,Perkins County,1224,187,1426,1037,0.858345021,0.131136045,0.727208976
Nebraska,31137,Phelps County,4158,758,4965,3400,0.837462236,0.152668681,0.684793555
Nebraska,31139,Pierce County,3420,446,3897,2974,0.877598152,0.114447011,0.763151142
Nebraska,31141,Platte County,12326,3191,15658,9135,0.787201431,0.203793588,0.583407843
Nebraska,31143,Polk County,2296,501,2819,1795,0.814473217,0.177722597,0.636750621
Nebraska,31145,Red Willow County,4457,815,5323,3642,0.837309788,0.153109149,0.684200639
Nebraska,31147,Richardson County,2962,934,3942,2028,0.751395231,0.236935566,0.514459665
Nebraska,31149,Rock County,745,85,834,660,0.893285372,0.101918465,0.791366906
Nebraska,31151,Saline County,3734,1855,5655,1879,0.660300619,0.328028294,0.332272325
Nebraska,31153,Sarpy County,55567,43825,100735,11742,0.551615625,0.435052365,0.11656326
Nebraska,31155,Saunders County,9854,3558,13565,6296,0.726428308,0.262292665,0.464135643
Nebraska,31157,Scotts Bluff County,11033,3856,15040,7177,0.733577128,0.256382979,0.477194149
Nebraska,31159,Seward County,6667,2388,9184,4279,0.725936411,0.260017422,0.46591899
Nebraska,31161,Sheridan County,2102,362,2484,1740,0.846215781,0.145732689,0.700483092
Nebraska,31163,Sherman County,1344,328,1687,1016,0.796680498,0.194427979,0.602252519
Nebraska,31165,Sioux County,597,77,678,520,0.880530973,0.113569322,0.766961652
Nebraska,31167,Stanton County,2536,492,3064,2044,0.82767624,0.160574413,0.667101828
Nebraska,31169,Thayer County,2278,544,2852,1734,0.798737728,0.190743338,0.60799439
Nebraska,31171,Thomas County,348,44,393,304,0.885496183,0.111959288,0.773536896
Nebraska,31173,Thurston County,1125,978,2123,147,0.529910504,0.460668865,0.069241639
Nebraska,31175,Valley County,1872,403,2299,1469,0.814267073,0.175293606,0.638973467
Nebraska,31177,Washington County,8855,3538,12545,5317,0.705858908,0.282024711,0.423834197
Nebraska,31179,Wayne County,3011,1006,4073,2005,0.739258532,0.246992389,0.492266143
Nebraska,31181,Webster County,1449,296,1763,1153,0.821894498,0.167895632,0.653998866
Nebraska,31183,Wheeler County,424,57,486,367,0.872427984,0.117283951,0.755144033
Nebraska,31185,York County,5234,1648,6984,3586,0.749427262,0.235967927,0.513459336
Nevada,32001,Churchill County,9962,3179,13503,6783,0.737761979,0.235429164,0.502332815
Nevada,32003,Clark County,493052,520187,1031223,-27135,0.478123548,0.504436965,-0.026313416
Nevada,32005,Douglas County,23237,11553,35556,11684,0.653532456,0.324924063,0.328608392
Nevada,32007,Elko County,17352,4632,22465,12720,0.772401513,0.206187403,0.566214111
Nevada,32009,Esmeralda County,376,73,461,303,0.815618221,0.15835141,0.657266811
Nevada,32011,Eureka County,910,104,1036,806,0.878378378,0.1003861,0.777992278
Nevada,32013,Humboldt County,6141,1711,8030,4430,0.764757161,0.213075965,0.551681196
Nevada,32015,Lander County,2180,482,2725,1698,0.8,0.176880734,0.623119266
Nevada,32017,Lincoln County,2108,314,2472,1794,0.852750809,0.127022654,0.725728155
Nevada,32019,Lyon County,23861,8954,33541,14907,0.711397991,0.266956859,0.444441132
Nevada,32021,Mineral County,1528,711,2295,817,0.665795207,0.309803922,0.355991285
Nevada,32023,Nye County,18946,7559,26997,11387,0.701781679,0.279994073,0.421787606
Nevada,32027,Pershing County,1764,496,2308,1268,0.764298094,0.214904679,0.549393414
Nevada,32029,Storey County,2108,913,3075,1195,0.685528455,0.296910569,0.388617886
Nevada,32031,Washoe County,127443,130071,263734,-2628,0.483225523,0.493190108,-0.009964586
Nevada,32033,White Pine County,3364,883,4351,2481,0.773155596,0.202941852,0.570213744
Nevada,32510,Carson City,16873,13375,31068,3498,0.543099009,0.430507274,0.112591734
New Hampshire,33001,Belknap County,22765,17469,40550,5296,0.561405672,0.43080148,0.130604192
New Hampshire,33003,Carroll County,17407,16827,34498,580,0.504579976,0.487767407,0.016812569
New Hampshire,33005,Cheshire County,20142,24579,45200,-4437,0.445619469,0.543783186,-0.098163717
New Hampshire,33007,Coos County,9731,7355,17230,2376,0.564770749,0.426871735,0.137899013
New Hampshire,33009,Grafton County,21911,32998,55603,-11087,0.394061472,0.593457188,-0.199395716
New Hampshire,33011,Hillsborough County,112068,118780,233234,-6712,0.480495983,0.509273948,-0.028777965
New Hampshire,33013,Merrimack County,43365,48181,92475,-4816,0.468937551,0.521016491,-0.05207894
New Hampshire,33015,Rockingham County,102542,97616,201949,4926,0.507761861,0.483369564,0.024392297
New Hampshire,33017,Strafford County,33163,42374,76323,-9211,0.434508602,0.555193061,-0.120684459
New Hampshire,33019,Sullivan County,12484,12317,25091,167,0.497548922,0.490893149,0.006655773
New Jersey,34001,Atlantic County,65817,61879,129759,3938,0.507224932,0.476876363,0.030348569
New Jersey,34003,Bergen County,217096,232660,459077,-15564,0.472896704,0.506799513,-0.033902809
New Jersey,34005,Burlington County,94116,132275,229466,-38159,0.410152267,0.576447055,-0.166294789
New Jersey,34007,Camden County,87767,155522,246954,-67755,0.355398171,0.629761008,-0.274362837
New Jersey,34009,Cape May County,32151,21648,54568,10503,0.589191468,0.396716024,0.192475443
New Jersey,34011,Cumberland County,28675,26577,55885,2098,0.513107274,0.475565894,0.03754138
New Jersey,34013,Essex County,83908,224596,313283,-140688,0.267834514,0.716910908,-0.449076394
New Jersey,34015,Gloucester County,83326,78708,164635,4618,0.506125672,0.478075743,0.028049929
New Jersey,34017,Hudson County,79913,144765,231181,-64852,0.345672871,0.626197655,-0.280524784
New Jersey,34019,Hunterdon County,42391,36995,80925,5396,0.523830707,0.457151684,0.066679024
New Jersey,34021,Mercer County,52274,107558,163270,-55284,0.320169045,0.65877381,-0.338604765
New Jersey,34023,Middlesex County,162459,191802,365187,-29343,0.444865233,0.525215848,-0.080350615
New Jersey,34025,Monmouth County,197409,156382,360143,41027,0.5481406,0.434221962,0.113918638
New Jersey,34027,Morris County,143439,135672,284666,7767,0.503885255,0.476600648,0.027284607
New Jersey,34029,Ocean County,227232,105789,337135,121443,0.674008928,0.313788245,0.360220683
New Jersey,34031,Passaic County,100954,95156,202767,5798,0.497881805,0.469287409,0.028594397
New Jersey,34033,Salem County,18229,12275,31001,5954,0.58801329,0.395954969,0.192058321
New Jersey,34035,Somerset County,74101,98790,177412,-24689,0.417677496,0.556839447,-0.139161951
New Jersey,34037,Sussex County,52123,31019,84629,21104,0.615899987,0.366529204,0.249370783
New Jersey,34039,Union County,89063,147327,240632,-58264,0.370121181,0.612250241,-0.24212906
New Jersey,34041,Warren County,35772,23318,60150,12454,0.594713217,0.387664173,0.207049044
New Mexico,35001,Bernalillo County,118762,184117,310844,-65355,0.382063028,0.592313186,-0.210250158
New Mexico,35003,Catron County,1752,571,2357,1181,0.743317777,0.242257106,0.50106067
New Mexico,35005,Chaves County,15894,5941,22200,9953,0.715945946,0.267612613,0.448333333
New Mexico,35006,Cibola County,4311,4450,8977,-139,0.480227247,0.495711262,-0.015484015
New Mexico,35007,Colfax County,3252,2436,5813,816,0.559435747,0.419060726,0.140375022
New Mexico,35009,Curry County,10714,4230,15223,6484,0.703803455,0.277869014,0.425934441
New Mexico,35011,De Baca County,649,206,874,443,0.742562929,0.235697941,0.506864989
New Mexico,35013,Doña Ana County,37594,45937,85407,-8343,0.440174693,0.537859894,-0.097685201
New Mexico,35015,Eddy County,18141,5032,23472,13109,0.772878323,0.214383095,0.558495228
New Mexico,35017,Grant County,6580,7301,14224,-721,0.462598425,0.513287402,-0.050688976
New Mexico,35019,Guadalupe County,945,959,1938,-14,0.487616099,0.494840041,-0.007223942
New Mexico,35021,Harding County,297,128,431,169,0.689095128,0.296983759,0.392111369
New Mexico,35023,Hidalgo County,1140,705,1862,435,0.612244898,0.378625134,0.233619764
New Mexico,35025,Lea County,16997,3930,21209,13067,0.801405064,0.185298694,0.61610637
New Mexico,35027,Lincoln County,6942,3033,10165,3909,0.682931628,0.298376783,0.384554845
New Mexico,35028,Los Alamos County,4047,7726,12187,-3679,0.332075162,0.633954214,-0.301879051
New Mexico,35029,Luna County,4698,3176,8056,1522,0.583167825,0.394240318,0.188927507
New Mexico,35031,McKinley County,9364,15711,25867,-6347,0.362005644,0.607376194,-0.245370549
New Mexico,35033,Mora County,1010,1439,2487,-429,0.406111781,0.578608766,-0.172496984
New Mexico,35035,Otero County,15117,8582,24242,6535,0.623587163,0.354013695,0.269573468
New Mexico,35037,Quay County,2570,1055,3704,1515,0.693844492,0.284827214,0.409017279
New Mexico,35039,Rio Arriba County,6268,9373,15989,-3105,0.392019513,0.586215523,-0.19419601
New Mexico,35041,Roosevelt County,4687,1820,6639,2867,0.705979816,0.274137671,0.431842145
New Mexico,35043,Sandoval County,36605,41205,79540,-4600,0.4602087,0.518041237,-0.057832537
New Mexico,35045,San Juan County,34264,17464,52926,16800,0.647394475,0.329970147,0.317424328
New Mexico,35047,San Miguel County,3887,6985,11108,-3098,0.34992798,0.628826071,-0.278898091
New Mexico,35049,Santa Fe County,20457,61405,83719,-40948,0.244353134,0.733465522,-0.489112388
New Mexico,35051,Sierra County,3473,2332,5953,1141,0.583403326,0.39173526,0.191668067
New Mexico,35053,Socorro County,3651,3384,7233,267,0.504769805,0.467855662,0.036914144
New Mexico,35055,Taos County,4139,12038,16636,-7899,0.248797788,0.723611445,-0.474813657
New Mexico,35057,Torrance County,4880,2144,7179,2736,0.679760412,0.298648837,0.381111575
New Mexico,35059,Union County,1247,378,1665,869,0.748948949,0.227027027,0.521921922
New Mexico,35061,Valencia County,19057,13609,33277,5448,0.572677826,0.408961144,0.163716681
New York,36001,Albany County,54560,92589,147149,-38029,0.370780637,0.629219363,-0.258438725
New York,36003,Allegany County,13826,5483,19309,8343,0.716039153,0.283960847,0.432078305
New York,36005,Bronx County,98174,261670,359844,-163496,0.272823779,0.727176221,-0.454352442
New York,36007,Broome County,44763,45142,89905,-379,0.49789222,0.50210778,-0.004215561
New York,36009,Cattaraugus County,22586,11424,34010,11162,0.664098794,0.335901206,0.328197589
New York,36011,Cayuga County,20482,15772,36254,4710,0.564958349,0.435041651,0.129916699
New York,36013,Chautauqua County,34528,22085,56613,12443,0.609895254,0.390104746,0.219790507
New York,36015,Chemung County,21861,15572,37433,6289,0.584003419,0.415996581,0.168006839
New York,36017,Chenango County,14294,8177,22471,6117,0.636108762,0.363891238,0.272217525
New York,36019,Clinton County,18247,17478,35725,769,0.510762771,0.489237229,0.021525542
New York,36021,Columbia County,15168,20396,35564,-5228,0.426498707,0.573501293,-0.147002587
New York,36023,Cortland County,11706,10290,21996,1416,0.53218767,0.46781233,0.064375341
New York,36025,Delaware County,13789,9237,23026,4552,0.598844784,0.401155216,0.197689568
New York,36027,Dutchess County,71778,79994,151772,-8216,0.472933084,0.527066916,-0.054133832
New York,36029,Erie County,204774,248651,453425,-43877,0.451616034,0.548383966,-0.096767933
New York,36031,Essex County,9533,9629,19162,-96,0.497495042,0.502504958,-0.005009915
New York,36033,Franklin County,10569,8821,19390,1748,0.545074781,0.454925219,0.090149562
New York,36035,Fulton County,16237,7666,23903,8571,0.679287119,0.320712881,0.358574238
New York,36037,Genesee County,18997,9367,28364,9630,0.669757439,0.330242561,0.339514878
New York,36039,Greene County,14702,10436,25138,4266,0.584851619,0.415148381,0.169703238
New York,36041,Hamilton County,2223,1211,3434,1012,0.647350029,0.352649971,0.294700058
New York,36043,Herkimer County,19557,9110,28667,10447,0.682212998,0.317787002,0.364425995
New York,36045,Jefferson County,26417,16326,42743,10091,0.61804272,0.38195728,0.236085441
New York,36047,Kings County,233964,601265,835229,-367301,0.280119584,0.719880416,-0.439760832
New York,36049,Lewis County,9353,3600,12953,5753,0.722072107,0.277927893,0.444144214
New York,36051,Livingston County,18780,12148,30928,6632,0.607216762,0.392783238,0.214433523
New York,36053,Madison County,19025,14629,33654,4396,0.565311701,0.434688299,0.130623403
New York,36055,Monroe County,145940,214757,360697,-68817,0.404605528,0.595394472,-0.190788945
New York,36057,Montgomery County,13286,7356,20642,5930,0.643639182,0.356360818,0.287278364
New York,36059,Nassau County,368117,338424,706541,29693,0.521012935,0.478987065,0.04202587
New York,36061,New York County,113921,533782,647703,-419861,0.175884626,0.824115374,-0.648230748
New York,36063,Niagara County,58678,43438,102116,15240,0.574621019,0.425378981,0.149242038
New York,36065,Oneida County,60687,39415,100102,21272,0.606251623,0.393748377,0.212503247
New York,36067,Onondaga County,93916,133155,227071,-39239,0.413597509,0.586402491,-0.172804982
New York,36069,Ontario County,30221,29520,59741,701,0.505866993,0.494133007,0.011733985
New York,36071,Orange County,94936,80253,175189,14683,0.54190617,0.45809383,0.08381234
New York,36073,Orleans County,12659,5366,18025,7293,0.702302358,0.297697642,0.404604716
New York,36075,Oswego County,33548,20483,54031,13065,0.620902815,0.379097185,0.24180563
New York,36077,Otsego County,15256,13031,28287,2225,0.53932902,0.46067098,0.078658041
New York,36079,Putnam County,31553,23956,55509,7597,0.568430345,0.431569655,0.136860689
New York,36081,Queens County,264628,437282,701910,-172654,0.377011298,0.622988702,-0.245977405
New York,36083,Rensselaer County,38601,39668,78269,-1067,0.493183764,0.506816236,-0.013632473
New York,36085,Richmond County,128151,69345,197496,58806,0.648878965,0.351121035,0.297757929
New York,36087,Rockland County,83543,65880,149423,17663,0.55910402,0.44089598,0.11820804
New York,36089,St. Lawrence County,25919,18010,43929,7909,0.59002026,0.40997974,0.18004052
New York,36091,Saratoga County,63940,66321,130261,-2381,0.490860657,0.509139343,-0.018278687
New York,36093,Schenectady County,31975,39733,71708,-7758,0.445905617,0.554094383,-0.108188766
New York,36095,Schoharie County,10423,5547,15970,4876,0.65266124,0.34733876,0.30532248
New York,36097,Schuyler County,5717,3736,9453,1981,0.604781551,0.395218449,0.209563102
New York,36099,Seneca County,8379,6610,14989,1769,0.559009941,0.440990059,0.118019881
New York,36101,Steuben County,29777,15413,45190,14364,0.658928967,0.341071033,0.317857933
New York,36103,Suffolk County,417549,341812,759361,75737,0.549868903,0.450131097,0.099737806
New York,36105,Sullivan County,20386,14549,34935,5837,0.583540862,0.416459138,0.167081723
New York,36107,Tioga County,15038,9437,24475,5601,0.61442288,0.38557712,0.228845761
New York,36109,Tompkins County,11354,34631,45985,-23277,0.2469066,0.7530934,-0.5061868
New York,36111,Ulster County,39743,57974,97717,-18231,0.406715311,0.593284689,-0.186569379
New York,36113,Warren County,18606,17099,35705,1507,0.521103487,0.478896513,0.042206974
New York,36115,Washington County,17268,11224,28492,6044,0.60606486,0.39393514,0.212129721
New York,36117,Wayne County,27286,17056,44342,10230,0.61535339,0.38464661,0.230706779
New York,36119,Westchester County,167795,287434,455229,-119639,0.368594707,0.631405293,-0.262810585
New York,36121,Wyoming County,14112,4929,19041,9183,0.741137545,0.258862455,0.482275091
New York,36123,Yates County,6098,4401,10499,1697,0.580817221,0.419182779,0.161634441
North Carolina,37001,Alamance County,47937,40624,89568,7313,0.535202304,0.453554841,0.081647463
North Carolina,37003,Alexander County,16404,4060,20625,12344,0.795345455,0.196848485,0.59849697
North Carolina,37005,Alleghany County,4900,1533,6480,3367,0.75617284,0.236574074,0.519598765
North Carolina,37007,Anson County,5525,5253,10859,272,0.508794548,0.483746201,0.025048347
North Carolina,37009,Ashe County,11629,4431,16187,7198,0.718416013,0.273738185,0.444677828
North Carolina,37011,Avery County,7181,2220,9468,4961,0.758449514,0.234474018,0.523975496
North Carolina,37013,Beaufort County,17296,9049,26521,8247,0.652162437,0.341201312,0.310961125
North Carolina,37015,Bertie County,3840,5279,9170,-1439,0.418756816,0.57568157,-0.156924755
North Carolina,37017,Bladen County,10035,6620,16743,3415,0.599354954,0.395389118,0.203965836
North Carolina,37019,Brunswick County,67658,40557,109049,27101,0.620436684,0.371915377,0.248521307
North Carolina,37021,Buncombe County,59016,98662,159885,-39646,0.369115302,0.617081027,-0.247965725
North Carolina,37023,Burke County,32130,13272,45733,18858,0.702556141,0.290206197,0.412349944
North Carolina,37025,Cabarrus County,63746,54494,119820,9252,0.532014689,0.454798865,0.077215824
North Carolina,37027,Caldwell County,33009,10146,43451,22863,0.759683321,0.233504407,0.526178914
North Carolina,37029,Camden County,4716,1522,6292,3194,0.749523204,0.241894469,0.507628735
North Carolina,37031,Carteret County,32508,12813,45693,19695,0.711443766,0.280414943,0.431028823
North Carolina,37033,Caswell County,7445,4493,12025,2952,0.619126819,0.373638254,0.245488565
North Carolina,37035,Catawba County,59577,26569,86885,33008,0.685699488,0.305795016,0.379904471
North Carolina,37037,Chatham County,22507,29014,52098,-6507,0.432012745,0.556911974,-0.124899228
North Carolina,37039,Cherokee County,13883,3686,17748,10197,0.782228984,0.207685373,0.574543611
North Carolina,37041,Chowan County,4587,2895,7533,1692,0.608920749,0.38430904,0.224611708
North Carolina,37043,Clay County,5761,1899,7708,3862,0.747405293,0.24636741,0.501037883
North Carolina,37045,Cleveland County,34654,16603,51602,18051,0.671563118,0.321751095,0.349812023
North Carolina,37047,Columbus County,17592,8648,26363,8944,0.667298866,0.328035504,0.339263362
North Carolina,37049,Craven County,33477,22011,56028,11466,0.597504819,0.392857143,0.204647676
North Carolina,37051,Cumberland County,59840,78631,140175,-18791,0.426894953,0.560948814,-0.134053861
North Carolina,37053,Currituck County,13235,4604,18010,8631,0.734869517,0.255635758,0.479233759
North Carolina,37055,Dare County,14792,10074,25115,4718,0.588970735,0.401114872,0.187855863
North Carolina,37057,Davidson County,67959,24150,93091,43809,0.730027607,0.259423575,0.470604033
North Carolina,37059,Davie County,19398,6988,26704,12410,0.726408029,0.261683643,0.464724386
North Carolina,37061,Duplin County,14677,8057,22864,6620,0.641926172,0.352388034,0.289538139
North Carolina,37063,Durham County,32853,144450,180189,-111597,0.182325225,0.801658259,-0.619333034
North Carolina,37065,Edgecombe County,9355,14900,24416,-5545,0.383150393,0.61025557,-0.227105177
North Carolina,37067,Forsyth County,87292,114145,203928,-26853,0.428053038,0.559731866,-0.131678828
North Carolina,37069,Franklin County,23938,18167,42526,5771,0.562902695,0.427197479,0.135705216
North Carolina,37071,Gaston County,73828,44062,118959,29766,0.620617187,0.370396523,0.250220664
North Carolina,37073,Gates County,3538,2268,5860,1270,0.603754266,0.387030717,0.216723549
North Carolina,37075,Graham County,3883,839,4769,3044,0.814216817,0.175927867,0.638288949
North Carolina,37077,Granville County,17383,14365,32044,3018,0.54247285,0.448289851,0.094182998
North Carolina,37079,Greene County,4965,3437,8442,1528,0.588130775,0.407131012,0.180999763
North Carolina,37081,Guilford County,109077,171118,284114,-62041,0.383919835,0.602286406,-0.218366571
North Carolina,37083,Halifax County,9778,14014,23938,-4236,0.408471886,0.585429025,-0.176957139
North Carolina,37085,Harnett County,39440,23472,63597,15968,0.620155039,0.369074013,0.251081026
North Carolina,37087,Haywood County,23393,13913,37724,9480,0.620109214,0.368810306,0.251298908
North Carolina,37089,Henderson County,39497,29361,69651,10136,0.567070107,0.421544558,0.145525549
North Carolina,37091,Hertford County,3561,6191,9819,-2630,0.362664222,0.630512272,-0.26784805
North Carolina,37093,Hoke County,10547,11896,22724,-1349,0.464134835,0.523499384,-0.059364548
North Carolina,37095,Hyde County,1465,931,2417,534,0.606123293,0.38518825,0.220935043
North Carolina,37097,Iredell County,72801,36739,110560,36062,0.658475036,0.332299204,0.326175832
North Carolina,37099,Jackson County,11796,9746,21864,2050,0.539517014,0.44575558,0.093761434
North Carolina,37101,Johnston County,74878,48116,124360,26762,0.602106787,0.386908974,0.215197813
North Carolina,37103,Jones County,3409,2007,5458,1402,0.624587761,0.367717112,0.256870649
North Carolina,37105,Lee County,17489,12245,30007,5244,0.582830673,0.40807145,0.174759223
North Carolina,37107,Lenoir County,14564,12700,27465,1864,0.530274895,0.462406699,0.067868196
North Carolina,37109,Lincoln County,40183,14842,55433,25341,0.724893114,0.267746649,0.457146465
North Carolina,37111,McDowell County,17520,5911,23600,11609,0.742372881,0.250466102,0.49190678
North Carolina,37113,Macon County,14981,6675,21846,8306,0.685754829,0.305547926,0.380206903
North Carolina,37115,Madison County,8275,5090,13561,3185,0.610205737,0.375341052,0.234864685
North Carolina,37117,Martin County,6601,5360,12028,1241,0.548802793,0.445626871,0.103175923
North Carolina,37119,Mecklenburg County,187770,376454,573679,-188684,0.327308477,0.65621018,-0.328901703
North Carolina,37121,Mitchell County,6843,1915,8821,4928,0.775762385,0.217095567,0.558666818
North Carolina,37123,Montgomery County,9044,4055,13188,4989,0.685774947,0.307476494,0.378298453
North Carolina,37125,Moore County,39617,21436,61590,18181,0.643237539,0.348043514,0.295194025
North Carolina,37127,Nash County,26431,25508,52364,923,0.504755175,0.487128562,0.017626614
North Carolina,37129,New Hanover County,67949,68814,138243,-865,0.491518558,0.497775656,-0.006257098
North Carolina,37131,Northampton County,3905,5239,9197,-1334,0.424594977,0.569642275,-0.145047298
North Carolina,37133,Onslow County,54960,25684,81476,29276,0.67455447,0.315233934,0.359320536
North Carolina,37135,Orange County,20806,65444,87426,-44638,0.237984124,0.7485645,-0.510580377
North Carolina,37137,Pamlico County,5229,2676,7961,2553,0.656827032,0.336138676,0.320688356
North Carolina,37139,Pasquotank County,10537,9549,20277,988,0.519652809,0.470927652,0.048725157
North Carolina,37141,Pender County,26042,12460,38837,13582,0.670546129,0.320828076,0.349718052
North Carolina,37143,Perquimans County,5278,2269,7640,3009,0.690837696,0.296989529,0.393848168
North Carolina,37145,Person County,13509,8295,21993,5214,0.614240895,0.377165462,0.237075433
North Carolina,37147,Pitt County,40403,45595,86924,-5192,0.464808338,0.524538677,-0.059730339
North Carolina,37149,Polk County,8107,4827,13032,3280,0.622084101,0.370395948,0.251688152
North Carolina,37151,Randolph County,59357,15951,75841,43406,0.782650545,0.210321594,0.572328951
North Carolina,37153,Richmond County,11931,7787,19848,4144,0.601118501,0.392331721,0.20878678
North Carolina,37155,Robeson County,29647,16728,46677,12919,0.635152216,0.358377788,0.276774429
North Carolina,37157,Rockingham County,33447,15676,49492,17771,0.675806191,0.316738059,0.359068132
North Carolina,37159,Rowan County,50807,23788,75236,27019,0.675301717,0.316178425,0.359123292
North Carolina,37161,Rutherford County,25456,8914,34600,16542,0.735722543,0.257630058,0.478092486
North Carolina,37163,Sampson County,18178,9797,28138,8381,0.646030279,0.348176843,0.297853437
North Carolina,37165,Scotland County,7767,6754,14613,1013,0.531513036,0.4621912,0.069321837
North Carolina,37167,Stanly County,27518,8881,36651,18637,0.75081171,0.242312624,0.508499086
North Carolina,37169,Stokes County,21548,5380,27127,16168,0.794337745,0.198326391,0.596011354
North Carolina,37171,Surry County,28565,8613,37424,19952,0.763280248,0.23014643,0.533133818
North Carolina,37173,Swain County,4311,2643,7036,1668,0.612706083,0.375639568,0.237066515
North Carolina,37175,Transylvania County,11492,8972,20706,2520,0.55500821,0.433304356,0.121703854
North Carolina,37177,Tyrrell County,1057,680,1752,377,0.603310502,0.388127854,0.215182648
North Carolina,37179,Union County,86271,51168,138875,35103,0.621213321,0.368446445,0.252766877
North Carolina,37181,Vance County,8614,11292,20059,-2678,0.429433172,0.562939329,-0.133506157
North Carolina,37183,Wake County,236735,402984,650796,-166249,0.363762223,0.619217082,-0.255454858
North Carolina,37185,Warren County,3976,5872,9985,-1896,0.398197296,0.588082123,-0.189884827
North Carolina,37187,Washington County,2768,3138,5939,-370,0.466071729,0.52837178,-0.062300051
North Carolina,37189,Watauga County,15254,17225,32934,-1971,0.463168762,0.523015728,-0.059846967
North Carolina,37191,Wayne County,31580,22618,54667,8962,0.577679404,0.41374138,0.163938025
North Carolina,37193,Wilkes County,28812,7194,36240,21618,0.795033113,0.198509934,0.596523179
North Carolina,37195,Wilson County,19750,19909,39978,-159,0.494021712,0.497998899,-0.003977187
North Carolina,37197,Yadkin County,16439,3739,20346,12700,0.807972083,0.183770766,0.624201317
North Carolina,37199,Yancey County,7509,3635,11247,3874,0.667644705,0.323197297,0.344447408
North Dakota,38001,Adams County,962,215,1191,747,0.807724601,0.180520571,0.62720403
North Dakota,38003,Barnes County,3531,1661,5294,1870,0.666981488,0.313751417,0.353230072
North Dakota,38005,Benson County,1163,795,1994,368,0.583249749,0.398696088,0.184553661
North Dakota,38007,Billings County,543,93,644,450,0.843167702,0.144409938,0.698757764
North Dakota,38009,Bottineau County,2628,735,3422,1893,0.767971946,0.214786674,0.553185272
North Dakota,38011,Bowman County,1384,207,1611,1177,0.859093731,0.12849162,0.73060211
North Dakota,38013,Burke County,909,130,1051,779,0.86489058,0.123691722,0.741198858
North Dakota,38015,Burleigh County,36595,14215,51764,22380,0.706958504,0.274611699,0.432346805
North Dakota,38017,Cass County,47873,40304,89842,7569,0.532857683,0.448609782,0.084247902
North Dakota,38019,Cavalier County,1461,491,1977,970,0.738998483,0.248356095,0.490642387
North Dakota,38021,Dickey County,1829,557,2435,1272,0.751129363,0.228747433,0.52238193
North Dakota,38023,Divide County,914,253,1194,661,0.765494137,0.211892797,0.55360134
North Dakota,38025,Dunn County,1877,332,2231,1545,0.841326759,0.148812192,0.692514567
North Dakota,38027,Eddy County,862,316,1201,546,0.717735221,0.263114072,0.454621149
North Dakota,38029,Emmons County,1697,205,1923,1492,0.882475299,0.106604264,0.775871035
North Dakota,38031,Foster County,1326,335,1692,991,0.783687943,0.197990544,0.5856974
North Dakota,38033,Golden Valley County,847,122,984,725,0.860772358,0.12398374,0.736788618
North Dakota,38035,Grand Forks County,18123,12469,31089,5654,0.582939303,0.401074335,0.181864968
North Dakota,38037,Grant County,1076,205,1304,871,0.825153374,0.157208589,0.667944785
North Dakota,38039,Griggs County,963,301,1285,662,0.749416342,0.234241245,0.515175097
North Dakota,38041,Hettinger County,1089,192,1294,897,0.841576507,0.148377125,0.693199382
North Dakota,38043,Kidder County,1137,238,1391,899,0.817397556,0.171099928,0.646297628
North Dakota,38045,LaMoure County,1614,453,2109,1161,0.765291607,0.214793741,0.550497866
North Dakota,38047,Logan County,898,117,1031,781,0.87099903,0.113482056,0.757516974
North Dakota,38049,McHenry County,2223,479,2735,1744,0.812797075,0.175137112,0.637659963
North Dakota,38051,McIntosh County,1132,229,1381,903,0.819695873,0.165821868,0.653874004
North Dakota,38053,McKenzie County,4627,809,5483,3818,0.843881087,0.147546963,0.696334124
North Dakota,38055,McLean County,4231,1093,5398,3138,0.783808818,0.202482401,0.581326417
North Dakota,38057,Mercer County,3798,672,4530,3126,0.838410596,0.148344371,0.690066225
North Dakota,38059,Morton County,12839,3748,16906,9091,0.75943452,0.221696439,0.537738081
North Dakota,38061,Mountrail County,2877,1125,4060,1752,0.70862069,0.277093596,0.431527094
North Dakota,38063,Nelson County,1141,580,1755,561,0.65014245,0.33048433,0.31965812
North Dakota,38065,Oliver County,909,156,1084,753,0.838560886,0.143911439,0.694649446
North Dakota,38067,Pembina County,2350,704,3088,1646,0.761010363,0.227979275,0.533031088
North Dakota,38069,Pierce County,1493,439,1955,1054,0.763682864,0.22455243,0.539130435
North Dakota,38071,Ramsey County,3609,1513,5204,2096,0.693504996,0.290737894,0.402767102
North Dakota,38073,Ransom County,1661,920,2632,741,0.631079027,0.349544073,0.281534954
North Dakota,38075,Renville County,993,179,1203,814,0.825436409,0.14879468,0.676641729
North Dakota,38077,Richland County,5576,2473,8199,3103,0.680082937,0.301622149,0.378460788
North Dakota,38079,Rolette County,1427,2567,4060,-1140,0.351477833,0.63226601,-0.280788177
North Dakota,38081,Sargent County,1325,663,2024,662,0.654644269,0.32756917,0.327075099
North Dakota,38083,Sheridan County,644,101,753,543,0.855245684,0.134130146,0.721115538
North Dakota,38085,Sioux County,285,654,950,-369,0.3,0.688421053,-0.388421053
North Dakota,38087,Slope County,351,33,387,318,0.906976744,0.085271318,0.821705426
North Dakota,38089,Stark County,12323,2473,15017,9850,0.820603316,0.164680029,0.655923287
North Dakota,38091,Steele County,622,367,1005,255,0.618905473,0.365174129,0.253731343
North Dakota,38093,Stutsman County,7185,2692,10073,4493,0.713292961,0.267249082,0.44604388
North Dakota,38095,Towner County,796,289,1110,507,0.717117117,0.26036036,0.456756757
North Dakota,38097,Traill County,2650,1359,4080,1291,0.649509804,0.333088235,0.316421569
North Dakota,38099,Walsh County,3186,1173,4456,2013,0.714991023,0.263240575,0.451750449
North Dakota,38101,Ward County,20635,7215,28326,13420,0.728482666,0.254712985,0.473769682
North Dakota,38103,Wells County,1815,405,2242,1410,0.809545049,0.180642284,0.628902765
North Dakota,38105,Williams County,12501,2276,15010,10225,0.83284477,0.151632245,0.681212525
Ohio,39001,Adams County,10269,2098,12429,8171,0.826212889,0.168798777,0.657414112
Ohio,39003,Allen County,33201,12754,46361,20447,0.716140722,0.275101918,0.441038804
Ohio,39005,Ashland County,19863,6544,26662,13319,0.744992874,0.245442953,0.499549921
Ohio,39007,Ashtabula County,27656,15345,43368,12311,0.63770522,0.353832319,0.283872902
Ohio,39009,Athens County,11369,14134,25726,-2765,0.441926456,0.549405271,-0.107478815
Ohio,39011,Auglaize County,20988,4442,25623,16546,0.819107833,0.173359872,0.645747961
Ohio,39013,Belmont County,22758,8080,31032,14678,0.733372003,0.260376386,0.472995617
Ohio,39015,Brown County,17257,4069,21442,13188,0.804822311,0.189767746,0.615054566
Ohio,39017,Butler County,114831,66713,183142,48118,0.627005275,0.364269256,0.262736019
Ohio,39019,Carroll County,10634,3071,13818,7563,0.769575915,0.222246345,0.54732957
Ohio,39021,Champaign County,15334,4944,20468,10390,0.749169435,0.241547782,0.507621653
Ohio,39023,Clark County,40403,21847,62835,18556,0.643001512,0.34768839,0.295313122
Ohio,39025,Clermont County,76964,36130,114115,40834,0.674442448,0.316610437,0.357832012
Ohio,39027,Clinton County,15984,4633,20779,11351,0.769238173,0.222965494,0.546272679
Ohio,39029,Columbiana County,35607,12064,48046,23543,0.741102277,0.251092703,0.490009574
Ohio,39031,Coshocton County,12362,3835,16333,8527,0.756872589,0.23480071,0.522071879
Ohio,39033,Crawford County,15402,4683,20241,10719,0.760930784,0.231362087,0.529568697
Ohio,39035,Cuyahoga County,195164,376384,575890,-181220,0.338891108,0.653569258,-0.31467815
Ohio,39037,Darke County,22234,4583,27000,17651,0.823481481,0.169740741,0.653740741
Ohio,39039,Defiance County,13302,5667,19153,7635,0.694512609,0.295880541,0.398632068
Ohio,39041,Delaware County,70448,61657,133357,8791,0.528266233,0.462345434,0.065920799
Ohio,39043,Erie County,22493,16871,39737,5622,0.566046757,0.424566525,0.141480233
Ohio,39045,Fairfield County,51999,31695,84431,20304,0.615875685,0.375395293,0.240480392
Ohio,39047,Fayette County,9706,2773,12571,6933,0.772094503,0.220587065,0.551507438
Ohio,39049,Franklin County,210830,380518,597530,-169688,0.352835841,0.636818235,-0.283982394
Ohio,39051,Fulton County,15893,6374,22452,9519,0.707865669,0.283894531,0.423971138
Ohio,39053,Gallia County,10314,2592,13000,7722,0.793384615,0.199384615,0.594
Ohio,39055,Geauga County,33844,20604,54886,13240,0.616623547,0.375396276,0.241227271
Ohio,39057,Greene County,53399,35575,90031,17824,0.593117926,0.395141673,0.197976253
Ohio,39059,Guernsey County,13314,4154,17594,9160,0.756735251,0.236103217,0.520632034
Ohio,39061,Hamilton County,172365,233360,409753,-60995,0.420655859,0.569513829,-0.148857971
Ohio,39063,Hancock County,26052,11467,37937,14585,0.686717453,0.30226428,0.384453172
Ohio,39065,Hardin County,9911,2863,12893,7048,0.768711704,0.222058481,0.546653223
Ohio,39067,Harrison County,5484,1559,7109,3925,0.771416514,0.21929948,0.552117035
Ohio,39069,Henry County,10873,3905,14911,6968,0.729193213,0.261887197,0.467306016
Ohio,39071,Highland County,16269,3609,19984,12660,0.814101281,0.180594476,0.633506805
Ohio,39073,Hocking County,9679,3704,13489,5975,0.717547631,0.274594114,0.442953518
Ohio,39075,Holmes County,10384,1854,12335,8530,0.841832185,0.150304013,0.691528172
Ohio,39077,Huron County,19484,7496,27212,11988,0.716007644,0.275466706,0.440540938
Ohio,39079,Jackson County,11249,2953,14285,8296,0.787469373,0.206720336,0.580749037
Ohio,39081,Jefferson County,22317,8592,31257,13725,0.713984068,0.274882426,0.439101641
Ohio,39083,Knox County,23112,8698,32090,14414,0.720224369,0.271050171,0.449174198
Ohio,39085,Lake County,72924,54484,128535,18440,0.567347415,0.423884545,0.14346287
Ohio,39087,Lawrence County,20013,6514,26712,13499,0.749213836,0.243860437,0.505353399
Ohio,39089,Licking County,61359,32832,95045,28527,0.64557841,0.345436372,0.300142038
Ohio,39091,Logan County,18182,5027,23403,13155,0.776908943,0.214801521,0.562107422
Ohio,39093,Lorain County,83297,74207,158959,9090,0.524015627,0.46683107,0.057184557
Ohio,39095,Lucas County,82398,106320,190525,-23922,0.432478677,0.558037003,-0.125558326
Ohio,39097,Madison County,14737,5713,20668,9024,0.713034643,0.27641765,0.436616992
Ohio,39099,Mahoning County,61249,50636,112678,10613,0.543575498,0.449386748,0.09418875
Ohio,39101,Marion County,19219,7902,27355,11317,0.702577225,0.28886858,0.413708646
Ohio,39103,Medina County,66308,39771,107017,26537,0.619602493,0.371632544,0.247969949
Ohio,39105,Meigs County,8127,2202,10400,5925,0.781442308,0.211730769,0.569711538
Ohio,39107,Mercer County,19710,3865,23750,15845,0.829894737,0.162736842,0.667157895
Ohio,39109,Miami County,42677,15969,59176,26708,0.721187644,0.269856023,0.451331621
Ohio,39111,Monroe County,5396,1336,6794,4060,0.794230203,0.196644098,0.597586105
Ohio,39113,Montgomery County,125566,126767,254715,-1201,0.492966649,0.497681723,-0.004715074
Ohio,39115,Morgan County,5168,1560,6782,3608,0.762017104,0.230020643,0.531996461
Ohio,39117,Morrow County,14609,4100,18855,10509,0.774807743,0.217448953,0.557358791
Ohio,39119,Muskingum County,28147,10874,39327,17273,0.715716937,0.276502149,0.439214789
Ohio,39121,Noble County,5050,1069,6161,3981,0.819672131,0.173510794,0.646161337
Ohio,39123,Ottawa County,14872,8866,23956,6006,0.620804809,0.370095174,0.250709634
Ohio,39125,Paulding County,7203,1987,9276,5216,0.776520052,0.214208711,0.562311341
Ohio,39127,Perry County,13062,3800,16991,9262,0.768759932,0.223647814,0.545112118
Ohio,39129,Pickaway County,21607,7397,29275,14210,0.738070026,0.252672929,0.485397096
Ohio,39131,Pike County,9352,2793,12218,6559,0.765428057,0.228597152,0.536830905
Ohio,39133,Portage County,47681,34759,83181,12922,0.573219846,0.41787187,0.155347976
Ohio,39135,Preble County,17146,4343,21653,12803,0.791853323,0.200572669,0.591280654
Ohio,39137,Putnam County,16576,2996,19754,13580,0.839121191,0.151665485,0.687455705
Ohio,39139,Richland County,41298,16591,58358,24707,0.707666472,0.284296926,0.423369547
Ohio,39141,Ross County,22801,9846,32930,12955,0.692408138,0.298997874,0.393410264
Ohio,39143,Sandusky County,19311,10139,29713,9172,0.649917545,0.341231111,0.308686434
Ohio,39145,Scioto County,22978,8021,31179,14957,0.736970397,0.257256487,0.47971391
Ohio,39147,Seneca County,17241,7765,25262,9476,0.682487531,0.307378672,0.375108859
Ohio,39149,Shelby County,20740,4350,25288,16390,0.820151851,0.172018349,0.648133502
Ohio,39151,Stark County,111478,71090,184158,40388,0.605338894,0.386027216,0.219311678
Ohio,39153,Summit County,125910,145005,273413,-19095,0.460512119,0.530351519,-0.0698394
Ohio,39155,Trumbull County,55983,39758,96514,16225,0.580050563,0.411940237,0.168110326
Ohio,39157,Tuscarawas County,30652,12032,43019,18620,0.712522374,0.279690369,0.432832004
Ohio,39159,Union County,23982,12934,37288,11048,0.643155975,0.346867625,0.29628835
Ohio,39161,Van Wert County,11616,3000,14729,8616,0.788648245,0.203679815,0.58496843
Ohio,39163,Vinton County,4531,1169,5737,3362,0.789785602,0.203765034,0.586020568
Ohio,39165,Warren County,91132,47128,139593,44004,0.652840758,0.337610052,0.315230706
Ohio,39167,Washington County,22161,8600,31000,13561,0.714870968,0.277419355,0.437451613
Ohio,39169,Wayne County,36764,15898,53140,20866,0.691832894,0.299171998,0.392660896
Ohio,39171,Williams County,13461,4644,18274,8817,0.736620335,0.254131553,0.482488782
Ohio,39173,Wood County,36877,30016,67565,6861,0.54580034,0.444253682,0.101546659
Ohio,39175,Wyandot County,8564,2731,11389,5833,0.751953639,0.239792783,0.512160857
Oklahoma,40001,Adair County,5860,1289,7256,4571,0.807607497,0.177646086,0.629961411
Oklahoma,40003,Alfalfa County,1891,236,2160,1655,0.875462963,0.109259259,0.766203704
Oklahoma,40005,Atoka County,4832,779,5662,4053,0.85340869,0.137583893,0.715824797
Oklahoma,40007,Beaver County,1938,158,2124,1780,0.912429379,0.074387947,0.838041431
Oklahoma,40009,Beckham County,6474,1093,7678,5381,0.84318833,0.14235478,0.70083355
Oklahoma,40011,Blaine County,3054,671,3786,2383,0.806656101,0.177231907,0.629424194
Oklahoma,40013,Bryan County,13999,3569,17812,10430,0.785930833,0.200370537,0.585560296
Oklahoma,40015,Caddo County,6886,2414,9496,4472,0.72514743,0.2542123,0.470935131
Oklahoma,40017,Canadian County,50551,21038,73074,29513,0.691778197,0.287899937,0.40387826
Oklahoma,40019,Carter County,14945,4277,19488,10668,0.766882184,0.219468391,0.547413793
Oklahoma,40021,Cherokee County,11637,5826,17823,5811,0.652920384,0.326880996,0.326039387
Oklahoma,40023,Choctaw County,4633,944,5639,3689,0.821599574,0.167405568,0.654194006
Oklahoma,40025,Cimarron County,860,66,935,794,0.919786096,0.070588235,0.849197861
Oklahoma,40027,Cleveland County,67225,49432,119294,17793,0.563523731,0.414371217,0.149152514
Oklahoma,40029,Coal County,2155,345,2538,1810,0.849093775,0.135933806,0.713159968
Oklahoma,40031,Comanche County,20823,12823,34284,8000,0.607367868,0.374022868,0.233345001
Oklahoma,40033,Cotton County,2067,392,2506,1675,0.824820431,0.156424581,0.66839585
Oklahoma,40035,Craig County,4740,1212,6056,3528,0.782694848,0.2001321,0.582562748
Oklahoma,40037,Creek County,24098,6643,31312,17455,0.769609096,0.212155084,0.557454011
Oklahoma,40039,Custer County,7693,2279,10168,5414,0.7565893,0.22413454,0.53245476
Oklahoma,40041,Delaware County,14407,3475,18108,10932,0.795615198,0.191904131,0.603711067
Oklahoma,40043,Dewey County,1984,209,2215,1775,0.895711061,0.094356659,0.801354402
Oklahoma,40045,Ellis County,1585,197,1812,1388,0.874724062,0.108719647,0.766004415
Oklahoma,40047,Garfield County,16593,4849,21844,11744,0.759613624,0.221983153,0.537630471
Oklahoma,40049,Garvin County,9063,1802,10991,7261,0.82458375,0.163952325,0.660631426
Oklahoma,40051,Grady County,20378,4536,25283,15842,0.805996124,0.179409089,0.626587035
Oklahoma,40053,Grant County,1794,295,2125,1499,0.844235294,0.138823529,0.705411765
Oklahoma,40055,Greer County,1511,304,1836,1207,0.822984749,0.165577342,0.657407407
Oklahoma,40057,Harmon County,709,165,882,544,0.803854875,0.18707483,0.616780045
Oklahoma,40059,Harper County,1284,147,1451,1137,0.884906961,0.101309442,0.783597519
Oklahoma,40061,Haskell County,4156,718,4936,3438,0.84197731,0.145461912,0.696515397
Oklahoma,40063,Hughes County,3744,831,4659,2913,0.803605924,0.178364456,0.625241468
Oklahoma,40065,Jackson County,6295,1602,8053,4693,0.781696262,0.198932075,0.582764187
Oklahoma,40067,Jefferson County,2020,319,2375,1701,0.850526316,0.134315789,0.716210526
Oklahoma,40069,Johnston County,3462,684,4230,2778,0.818439716,0.161702128,0.656737589
Oklahoma,40071,Kay County,12483,4136,16913,8347,0.738071306,0.244545616,0.49352569
Oklahoma,40073,Kingfisher County,5745,923,6754,4822,0.850607048,0.136659757,0.71394729
Oklahoma,40075,Kiowa County,2569,658,3278,1911,0.783709579,0.200732154,0.582977425
Oklahoma,40077,Latimer County,3356,681,4079,2675,0.822750674,0.166952684,0.65579799
Oklahoma,40079,Le Flore County,15333,3184,18754,12149,0.817585582,0.169777114,0.647808468
Oklahoma,40081,Lincoln County,12495,2712,15465,9783,0.807953443,0.175363725,0.632589719
Oklahoma,40083,Logan County,17748,5901,24149,11847,0.734937264,0.244357944,0.49057932
Oklahoma,40085,Love County,3510,689,4260,2821,0.823943662,0.161737089,0.662206573
Oklahoma,40087,McClain County,17005,4031,21397,12974,0.79473758,0.188390896,0.606346684
Oklahoma,40089,McCurtain County,9485,1696,11309,7789,0.83871253,0.149969051,0.688743479
Oklahoma,40091,McIntosh County,6387,1937,8439,4450,0.756843228,0.229529565,0.527313663
Oklahoma,40093,Major County,3087,327,3478,2760,0.887579068,0.094019551,0.793559517
Oklahoma,40095,Marshall County,5348,1169,6589,4179,0.81165579,0.177416907,0.634238883
Oklahoma,40097,Mayes County,13514,3529,17374,9985,0.77782894,0.203119604,0.574709336
Oklahoma,40099,Murray County,4689,1080,5885,3609,0.796771453,0.183517417,0.613254036
Oklahoma,40101,Muskogee County,16550,7400,24357,9150,0.679476126,0.303814099,0.375662027
Oklahoma,40103,Noble County,3853,1009,4957,2844,0.777284648,0.203550535,0.573734113
Oklahoma,40105,Nowata County,3774,720,4561,3054,0.827450121,0.157860118,0.669590002
Oklahoma,40107,Okfuskee County,3080,854,3988,2226,0.772316951,0.214142427,0.558174524
Oklahoma,40109,Oklahoma County,143618,138769,288923,4849,0.497080537,0.480297519,0.016783018
Oklahoma,40111,Okmulgee County,10100,3979,14349,6121,0.703881804,0.277301554,0.426580249
Oklahoma,40113,Osage County,14404,5867,20628,8537,0.69827419,0.284419236,0.413854954
Oklahoma,40115,Ottawa County,8490,2511,11178,5979,0.759527644,0.224637681,0.534889962
Oklahoma,40117,Pawnee County,5405,1355,6880,4050,0.785610465,0.196947674,0.588662791
Oklahoma,40119,Payne County,17962,10560,29279,7402,0.613477236,0.360668056,0.252809181
Oklahoma,40121,Pittsburg County,13841,3473,17572,10368,0.787673572,0.197643979,0.590029593
Oklahoma,40123,Pontotoc County,10967,3895,15174,7072,0.72274944,0.256689073,0.466060366
Oklahoma,40125,Pottawatomie County,20915,7266,28774,13649,0.726871481,0.252519636,0.474351845
Oklahoma,40127,Pushmataha County,4025,616,4702,3409,0.856018715,0.131008082,0.725010634
Oklahoma,40129,Roger Mills County,1548,160,1733,1388,0.893248702,0.092325447,0.800923254
Oklahoma,40131,Rogers County,35942,10146,46902,25796,0.766321266,0.216323398,0.549997868
Oklahoma,40133,Seminole County,5951,1951,8044,4000,0.739806067,0.242541024,0.497265042
Oklahoma,40135,Sequoyah County,12491,2907,15583,9584,0.801578643,0.186549445,0.615029198
Oklahoma,40137,Stephens County,15092,3236,18620,11856,0.810526316,0.173791622,0.636734694
Oklahoma,40139,Texas County,4319,793,5206,3526,0.82961967,0.152324241,0.677295428
Oklahoma,40141,Tillman County,2006,500,2533,1506,0.791946309,0.197394394,0.594551915
Oklahoma,40143,Tulsa County,145241,106105,256939,39136,0.565274248,0.412957939,0.152316309
Oklahoma,40145,Wagoner County,28487,9330,38501,19157,0.73990286,0.242331368,0.497571492
Oklahoma,40147,Washington County,16836,5793,23174,11043,0.726503841,0.249978424,0.476525416
Oklahoma,40149,Washita County,4030,551,4652,3479,0.866294067,0.11844368,0.747850387
Oklahoma,40151,Woods County,2955,614,3638,2341,0.812259483,0.168774052,0.643485432
Oklahoma,40153,Woodward County,6231,967,7312,5264,0.852160832,0.132248359,0.719912473
Oregon,41001,Baker County,6984,2301,9523,4683,0.733382337,0.241625538,0.491756799
Oregon,41003,Benton County,14041,33579,49336,-19538,0.284599481,0.680618615,-0.396019134
Oregon,41005,Clackamas County,103832,126979,237953,-23147,0.436355079,0.533630591,-0.097275512
Oregon,41007,Clatsop County,9829,12442,22989,-2613,0.427552308,0.541215364,-0.113663056
Oregon,41009,Columbia County,17184,12865,31094,4319,0.552646813,0.413745417,0.138901396
Oregon,41011,Coos County,20587,13596,35166,6991,0.58542342,0.386623443,0.198799977
Oregon,41013,Crook County,11804,3731,15892,8073,0.742763655,0.234772212,0.507991442
Oregon,41015,Curry County,7943,5685,14018,2258,0.56662862,0.405550007,0.161078613
Oregon,41017,Deschutes County,53318,65677,122417,-12359,0.435544083,0.536502283,-0.1009582
Oregon,41019,Douglas County,41059,18181,60756,22878,0.675801567,0.299246165,0.376555402
Oregon,41021,Gilliam County,805,291,1130,514,0.712389381,0.257522124,0.454867257
Oregon,41023,Grant County,3483,813,4421,2670,0.787830808,0.183895046,0.603935761
Oregon,41025,Harney County,3305,795,4227,2510,0.781878401,0.18807665,0.593801751
Oregon,41027,Hood River County,3854,8364,12620,-4510,0.305388273,0.662757528,-0.357369255
Oregon,41029,Jackson County,61535,53907,118577,7628,0.518945495,0.454615988,0.064329507
Oregon,41031,Jefferson County,7438,3921,11653,3517,0.638290569,0.336479876,0.301810693
Oregon,41033,Josephine County,30696,16592,48521,14104,0.632633293,0.34195503,0.290678263
Oregon,41035,Klamath County,24613,9829,35281,14784,0.697627618,0.278591877,0.419035742
Oregon,41037,Lake County,3367,670,4130,2697,0.815254237,0.162227603,0.653026634
Oregon,41039,Lane County,76149,123957,206547,-47808,0.368676379,0.600139436,-0.231463057
Oregon,41041,Lincoln County,11645,17112,29671,-5467,0.392470763,0.576724748,-0.184253985
Oregon,41043,Linn County,43078,25749,71052,17329,0.606288352,0.362396555,0.243891798
Oregon,41045,Malheur County,7593,2830,10738,4763,0.707114919,0.263550009,0.44356491
Oregon,41047,Marion County,77083,73967,155732,3116,0.494972132,0.474963399,0.020008733
Oregon,41049,Morrow County,3402,1132,4693,2270,0.72490944,0.241210313,0.483699126
Oregon,41051,Multnomah County,70231,323969,408474,-253738,0.171935056,0.793120248,-0.621185192
Oregon,41053,Polk County,23695,21908,47025,1787,0.503880914,0.465879851,0.038001063
Oregon,41055,Sherman County,877,229,1138,648,0.770650264,0.201230228,0.569420035
Oregon,41057,Tillamook County,7944,7726,16130,218,0.49249845,0.478983261,0.013515189
Oregon,41059,Umatilla County,20809,9170,30832,11639,0.674915672,0.297418267,0.377497405
Oregon,41061,Union County,9872,4043,14364,5829,0.68727374,0.281467558,0.405806182
Oregon,41063,Wallowa County,3366,1573,5082,1793,0.662337662,0.30952381,0.352813853
Oregon,41065,Wasco County,6754,6005,13185,749,0.512248768,0.45544179,0.056806978
Oregon,41067,Washington County,92427,192641,295038,-100214,0.313271511,0.652936232,-0.339664721
Oregon,41069,Wheeler County,616,210,863,406,0.713789108,0.243337196,0.470451912
Oregon,41071,Yamhill County,29484,25971,57324,3513,0.514339544,0.453056311,0.061283232
Pennsylvania,42001,Adams County,40248,19842,60650,20406,0.663610882,0.327155812,0.33645507
Pennsylvania,42003,Allegheny County,283595,429916,720504,-146321,0.39360642,0.596687874,-0.203081454
Pennsylvania,42005,Armstrong County,28296,8553,37119,19743,0.762305019,0.230421078,0.531883941
Pennsylvania,42007,Beaver County,56837,37196,94843,19641,0.599274591,0.392184979,0.207089611
Pennsylvania,42009,Bedford County,23658,4336,28160,19322,0.840127841,0.153977273,0.686150568
Pennsylvania,42011,Berks County,116677,91125,209838,25552,0.556033702,0.434263575,0.121770127
Pennsylvania,42013,Blair County,46352,18127,64949,28225,0.713667647,0.279095906,0.434571741
Pennsylvania,42015,Bradford County,22937,7990,31192,14947,0.735348807,0.256155424,0.479193383
Pennsylvania,42017,Bucks County,198722,198431,401028,291,0.495531484,0.494805849,0.000725635
Pennsylvania,42019,Butler County,79773,40661,121440,39112,0.656892292,0.334823781,0.322068511
Pennsylvania,42021,Cambria County,49408,21177,71136,28231,0.694556905,0.297697368,0.396859537
Pennsylvania,42023,Cameron County,1654,538,2219,1116,0.745380802,0.242451555,0.502929247
Pennsylvania,42025,Carbon County,23708,11394,35395,12314,0.66981212,0.321909874,0.347902246
Pennsylvania,42027,Centre County,38829,41119,80792,-2290,0.480604515,0.508948906,-0.028344391
Pennsylvania,42029,Chester County,137299,184281,324964,-46982,0.422505262,0.567081277,-0.144576015
Pennsylvania,42031,Clarion County,15036,4562,19733,10474,0.761972331,0.231186338,0.530785993
Pennsylvania,42033,Clearfield County,30481,9647,40430,20834,0.753920356,0.238609943,0.515310413
Pennsylvania,42035,Clinton County,12965,5395,18522,7570,0.699978404,0.29127524,0.408703164
Pennsylvania,42037,Columbia County,21190,11083,32576,10107,0.65047888,0.340219794,0.310259086
Pennsylvania,42039,Crawford County,29685,12858,42872,16827,0.692409965,0.299916029,0.392493935
Pennsylvania,42041,Cumberland County,80267,66255,148396,14012,0.540897329,0.446474298,0.09442303
Pennsylvania,42043,Dauphin County,69474,78327,149526,-8853,0.464628225,0.52383532,-0.059207094
Pennsylvania,42045,Delaware County,123421,201324,328172,-77903,0.376086321,0.613470985,-0.237384664
Pennsylvania,42047,Elk County,12543,4483,17153,8060,0.731242348,0.261353699,0.469888649
Pennsylvania,42049,Erie County,68866,67456,137595,1410,0.500497838,0.490250372,0.010247465
Pennsylvania,42051,Fayette County,43633,19548,63472,24085,0.68743698,0.307978321,0.379458659
Pennsylvania,42053,Forest County,1902,724,2650,1178,0.717735849,0.273207547,0.444528302
Pennsylvania,42055,Franklin County,59604,23543,83884,36061,0.710552668,0.28066139,0.429891278
Pennsylvania,42057,Fulton County,7039,1102,8177,5937,0.860829155,0.134768252,0.726060903
Pennsylvania,42059,Greene County,12319,4592,17236,7727,0.714724994,0.266419123,0.448305871
Pennsylvania,42061,Huntingdon County,17627,5368,23156,12259,0.761228191,0.231818967,0.529409224
Pennsylvania,42063,Indiana County,29215,12697,42229,16518,0.691823155,0.300670156,0.391152999
Pennsylvania,42065,Jefferson County,18235,4707,23129,13528,0.788404168,0.203510744,0.584893424
Pennsylvania,42067,Juniata County,9721,2290,12104,7431,0.803122935,0.189193655,0.61392928
Pennsylvania,42069,Lackawanna County,56261,59510,116590,-3249,0.48255425,0.510421134,-0.027866884
Pennsylvania,42071,Lancaster County,166261,120119,289257,46142,0.574786436,0.415267392,0.159519044
Pennsylvania,42073,Lawrence County,31347,15440,47110,15907,0.665400127,0.327743579,0.337656549
Pennsylvania,42075,Lebanon County,48282,24734,73692,23548,0.655186452,0.335640232,0.319546219
Pennsylvania,42077,Lehigh County,91207,96317,189810,-5110,0.480517359,0.507439018,-0.026921659
Pennsylvania,42079,Luzerne County,92444,62504,156150,29940,0.592020493,0.40028178,0.191738713
Pennsylvania,42081,Lycoming County,41961,17216,59685,24745,0.703040965,0.288447684,0.414593281
Pennsylvania,42083,McKean County,14401,5115,19682,9286,0.731683772,0.259882126,0.471801646
Pennsylvania,42085,Mercer County,37761,20145,58410,17616,0.646481767,0.344889574,0.301592193
Pennsylvania,42087,Mifflin County,17184,4735,22071,12449,0.778578225,0.21453491,0.564043315
Pennsylvania,42089,Monroe County,42676,42007,85525,669,0.4989886,0.491166326,0.007822274
Pennsylvania,42091,Montgomery County,198311,317103,520906,-118792,0.380704004,0.608752827,-0.228048823
Pennsylvania,42093,Montour County,5944,3862,9908,2082,0.599919257,0.389786031,0.210133226
Pennsylvania,42095,Northampton County,89817,86655,178215,3162,0.503981146,0.486238532,0.017742614
Pennsylvania,42097,Northumberland County,30240,12863,43522,17377,0.69482101,0.295551675,0.399269335
Pennsylvania,42099,Perry County,19073,6385,25725,12688,0.741418853,0.248202138,0.493216715
Pennsylvania,42101,Philadelphia County,144311,568571,721441,-424260,0.200031603,0.788104641,-0.588073037
Pennsylvania,42103,Pike County,21537,13132,34950,8405,0.616223176,0.375736767,0.240486409
Pennsylvania,42105,Potter County,7334,1675,9085,5659,0.807264722,0.18436984,0.622894882
Pennsylvania,42107,Schuylkill County,51665,20882,73184,30783,0.705960319,0.285335592,0.420624727
Pennsylvania,42109,Snyder County,14664,5239,20038,9425,0.731809562,0.261453239,0.470356323
Pennsylvania,42111,Somerset County,31993,8596,40881,23397,0.782588489,0.210268829,0.572319659
Pennsylvania,42113,Sullivan County,2721,976,3721,1745,0.731255039,0.262295082,0.468959957
Pennsylvania,42115,Susquehanna County,16114,6093,22404,10021,0.719246563,0.271960364,0.447286199
Pennsylvania,42117,Tioga County,16272,5100,21587,11172,0.753787001,0.236253301,0.517533701
Pennsylvania,42119,Union County,12969,8015,21188,4954,0.61209175,0.378280159,0.233811591
Pennsylvania,42121,Venango County,18883,7624,26732,11259,0.706381864,0.285201257,0.421180608
Pennsylvania,42123,Warren County,14345,6212,20723,8133,0.692226029,0.299763548,0.392462481
Pennsylvania,42125,Washington County,75929,44910,121617,31019,0.624328836,0.369274032,0.255054803
Pennsylvania,42127,Wayne County,20071,9150,29444,10921,0.681666893,0.310759408,0.370907485
Pennsylvania,42129,Westmoreland County,135008,74904,211450,60104,0.63848664,0.354239773,0.284246867
Pennsylvania,42131,Wyoming County,10222,4680,15052,5542,0.67911241,0.310922137,0.368190274
Pennsylvania,42133,York County,154884,91926,249210,62958,0.62149994,0.368869628,0.252630312
Rhode Island,44001,Bristol County,10048,17458,28117,-7410,0.357363872,0.620905502,-0.26354163
Rhode Island,44003,Kent County,44526,46269,92648,-1743,0.480593213,0.499406355,-0.018813142
Rhode Island,44005,Newport County,16027,27332,44349,-11305,0.361383571,0.61629349,-0.254909919
Rhode Island,44007,Providence County,112558,151508,269989,-38950,0.416898466,0.561163603,-0.144265137
Rhode Island,44009,Washington County,31247,42589,75556,-11342,0.413560803,0.563674625,-0.150113823
South Carolina,45001,Abbeville County,8509,3399,12048,5110,0.7062583,0.282121514,0.424136786
South Carolina,45003,Aiken County,53592,31298,86091,22294,0.622504095,0.363545551,0.258958544
South Carolina,45005,Allendale County,813,2165,3023,-1352,0.268938141,0.716175984,-0.447237843
South Carolina,45007,Anderson County,71828,25281,98296,46547,0.730731668,0.257192561,0.473539106
South Carolina,45009,Bamberg County,2376,3245,5694,-869,0.417281349,0.569898138,-0.15261679
South Carolina,45011,Barnwell County,5605,4082,9803,1523,0.571763746,0.416403142,0.155360604
South Carolina,45013,Beaufort County,59123,44002,104403,15121,0.566295988,0.421462985,0.144833003
South Carolina,45015,Berkeley County,64777,46416,112834,18361,0.574091143,0.411365369,0.162725774
South Carolina,45017,Calhoun County,4474,3339,7914,1135,0.565327268,0.421910538,0.14341673
South Carolina,45019,Charleston County,99265,111427,214521,-12162,0.462728591,0.519422341,-0.05669375
South Carolina,45021,Cherokee County,18697,5939,24839,12758,0.752727566,0.239099803,0.513627763
South Carolina,45023,Chester County,9030,6353,15556,2677,0.580483415,0.408395474,0.17208794
South Carolina,45025,Chesterfield County,11682,6520,18391,5162,0.635202001,0.354521233,0.280680768
South Carolina,45027,Clarendon County,9065,7064,16320,2001,0.555453431,0.432843137,0.122610294
South Carolina,45029,Colleton County,10696,7376,18276,3320,0.585248413,0.403589407,0.181659006
South Carolina,45031,Darlington County,17017,12977,30331,4040,0.561043157,0.427846098,0.133197059
South Carolina,45033,Dillon County,6526,5241,11861,1285,0.550206559,0.441868308,0.108338251
South Carolina,45035,Dorchester County,43839,32489,77764,11350,0.563744149,0.417789723,0.145954426
South Carolina,45037,Edgefield County,9092,4659,13919,4433,0.653207845,0.334722322,0.318485523
South Carolina,45039,Fairfield County,4792,6277,11215,-1485,0.427284886,0.559696835,-0.132411948
South Carolina,45041,Florence County,32615,27706,61140,4909,0.533447825,0.45315669,0.080291135
South Carolina,45043,Georgetown County,22326,14965,37754,7361,0.591354558,0.39638184,0.194972718
South Carolina,45045,Greenville County,158541,100074,263316,58467,0.602094062,0.380052864,0.222041198
South Carolina,45047,Greenwood County,19715,10766,30888,8949,0.638273763,0.348549599,0.289724165
South Carolina,45049,Hampton County,3801,4328,8233,-527,0.46167861,0.525689299,-0.064010689
South Carolina,45051,Horry County,141719,62325,205954,79394,0.688109966,0.302616118,0.385493848
South Carolina,45053,Jasper County,9900,8144,18227,1756,0.543150272,0.446809678,0.096340594
South Carolina,45055,Kershaw County,21289,11826,33533,9463,0.634867146,0.352667522,0.282199624
South Carolina,45057,Lancaster County,33623,20146,54427,13477,0.617763243,0.37014717,0.247616073
South Carolina,45059,Laurens County,21110,8769,30213,12341,0.698705855,0.290239301,0.408466554
South Carolina,45061,Lee County,3078,4505,8076,-1427,0.381129272,0.557825656,-0.176696384
South Carolina,45063,Lexington County,96965,47815,146903,49150,0.660061401,0.325486886,0.334574515
South Carolina,45065,McCormick County,3565,2513,6153,1052,0.579392166,0.408418658,0.170973509
South Carolina,45067,Marion County,5906,7316,13388,-1410,0.441141321,0.546459516,-0.105318195
South Carolina,45069,Marlboro County,4896,5137,10152,-241,0.482269504,0.506008668,-0.023739165
South Carolina,45071,Newberry County,12067,5841,18129,6226,0.665618622,0.322190965,0.343427657
South Carolina,45073,Oconee County,31772,9987,42264,21785,0.751750899,0.236300398,0.515450502
South Carolina,45075,Orangeburg County,13750,22832,36970,-9082,0.371923181,0.617581823,-0.245658642
South Carolina,45077,Pickens County,45728,13891,60451,31837,0.756447371,0.229789416,0.526657954
South Carolina,45079,Richland County,58019,121110,182411,-63091,0.318067441,0.663940223,-0.345872782
South Carolina,45081,Saluda County,6452,2454,9014,3998,0.71577546,0.272243177,0.443532283
South Carolina,45083,Spartanburg County,103032,50710,155597,52322,0.66217215,0.325906026,0.336266123
South Carolina,45085,Sumter County,21215,23425,45170,-2210,0.469670135,0.518596414,-0.048926279
South Carolina,45087,Union County,8102,4084,12289,4018,0.659288795,0.332329726,0.326959069
South Carolina,45089,Williamsburg County,5524,8634,14330,-3110,0.385484997,0.602512212,-0.217027216
South Carolina,45091,York County,88239,59600,150059,28639,0.588028709,0.39717711,0.190851598
South Dakota,46003,Aurora County,1056,302,1393,754,0.758076095,0.216798277,0.541277818
South Dakota,46005,Beadle County,4826,2017,7010,2809,0.688445078,0.287731812,0.400713267
South Dakota,46007,Bennett County,676,389,1088,287,0.621323529,0.357536765,0.263786765
South Dakota,46009,Bon Homme County,2236,697,2992,1539,0.747326203,0.232954545,0.514371658
South Dakota,46011,Brookings County,8575,5978,14939,2597,0.574000937,0.400160653,0.173840284
South Dakota,46013,Brown County,10645,6075,17043,4570,0.624596609,0.356451329,0.26814528
South Dakota,46015,Brule County,1694,666,2423,1028,0.699133306,0.274865869,0.424267437
South Dakota,46017,Buffalo County,164,291,466,-127,0.35193133,0.624463519,-0.272532189
South Dakota,46019,Butte County,4024,942,5082,3082,0.791814246,0.185360094,0.606454152
South Dakota,46021,Campbell County,706,120,836,586,0.844497608,0.14354067,0.700956938
South Dakota,46023,Charles Mix County,2551,1000,3615,1551,0.705670816,0.276625173,0.429045643
South Dakota,46025,Clark County,1382,415,1842,967,0.750271444,0.225298588,0.524972856
South Dakota,46027,Clay County,2574,2944,5657,-370,0.45501149,0.520417182,-0.065405692
South Dakota,46029,Codington County,9349,3840,13510,5509,0.692005922,0.284233901,0.407772021
South Dakota,46031,Corson County,631,495,1143,136,0.552055993,0.433070866,0.118985127
South Dakota,46033,Custer County,4313,1567,6001,2746,0.718713548,0.261123146,0.457590402
South Dakota,46035,Davison County,6208,2743,9177,3465,0.676473793,0.298899422,0.377574371
South Dakota,46037,Day County,1876,1000,2932,876,0.639836289,0.34106412,0.298772169
South Dakota,46039,Deuel County,1717,528,2298,1189,0.747171453,0.229765013,0.51740644
South Dakota,46041,Dewey County,793,1032,1871,-239,0.42383752,0.551576697,-0.127739177
South Dakota,46043,Douglas County,1419,219,1658,1200,0.855850422,0.132086852,0.723763571
South Dakota,46045,Edmunds County,1618,384,2031,1234,0.796651896,0.189069424,0.607582472
South Dakota,46047,Fall River County,3135,1030,4274,2105,0.733504913,0.240992045,0.492512869
South Dakota,46049,Faulk County,920,183,1130,737,0.814159292,0.161946903,0.652212389
South Dakota,46051,Grant County,2594,946,3630,1648,0.714600551,0.260606061,0.45399449
South Dakota,46053,Gregory County,1790,426,2267,1364,0.789589766,0.187913542,0.601676224
South Dakota,46055,Haakon County,1004,105,1125,899,0.892444444,0.093333333,0.799111111
South Dakota,46057,Hamlin County,2560,610,3226,1950,0.793552387,0.189088655,0.604463732
South Dakota,46059,Hand County,1376,365,1764,1011,0.780045351,0.2069161,0.573129252
South Dakota,46061,Hanson County,1611,399,2046,1212,0.787390029,0.195014663,0.592375367
South Dakota,46063,Harding County,754,48,820,706,0.919512195,0.058536585,0.86097561
South Dakota,46065,Hughes County,5379,2838,8435,2541,0.637700059,0.336455246,0.301244813
South Dakota,46067,Hutchinson County,2918,755,3736,2163,0.781049251,0.202087794,0.578961456
South Dakota,46069,Hyde County,530,148,695,382,0.762589928,0.21294964,0.549640288
South Dakota,46071,Jackson County,753,357,1129,396,0.666961913,0.316209035,0.350752879
South Dakota,46073,Jerauld County,708,276,999,432,0.708708709,0.276276276,0.432432432
South Dakota,46075,Jones County,477,60,550,417,0.867272727,0.109090909,0.758181818
South Dakota,46077,Kingsbury County,1989,760,2801,1229,0.710103534,0.271331667,0.438771867
South Dakota,46079,Lake County,3819,1978,5906,1841,0.646630545,0.334913647,0.311716898
South Dakota,46081,Lawrence County,9904,5074,15409,4830,0.642741255,0.329288078,0.313453177
South Dakota,46083,Lincoln County,22621,12981,36393,9640,0.621575578,0.356689473,0.264886104
South Dakota,46085,Lyman County,993,422,1447,571,0.686247408,0.291637871,0.394609537
South Dakota,46087,McCook County,2227,733,3031,1494,0.73474101,0.241834378,0.492906631
South Dakota,46089,McPherson County,1087,188,1299,899,0.836797537,0.144726713,0.692070824
South Dakota,46091,Marshall County,1288,782,2109,506,0.610715979,0.370791844,0.239924135
South Dakota,46093,Meade County,10887,3421,14672,7466,0.742025627,0.233165213,0.508860414
South Dakota,46095,Mellette County,434,285,740,149,0.586486486,0.385135135,0.201351351
South Dakota,46097,Miner County,841,293,1167,548,0.720651243,0.251071123,0.46958012
South Dakota,46099,Minnehaha County,51842,39923,93986,11919,0.55159279,0.42477603,0.12681676
South Dakota,46101,Moody County,2068,1052,3189,1016,0.648479147,0.329883976,0.318595171
South Dakota,46102,Oglala Lakota County,406,2567,3062,-2161,0.132593076,0.838340954,-0.705747877
South Dakota,46103,Pennington County,35009,20051,56580,14958,0.618752209,0.354383174,0.264369035
South Dakota,46105,Perkins County,1342,228,1591,1114,0.843494657,0.143306097,0.700188561
South Dakota,46107,Potter County,1059,214,1298,845,0.81587057,0.164869029,0.651001541
South Dakota,46109,Roberts County,2514,1560,4149,954,0.60592914,0.375994215,0.229934924
South Dakota,46111,Sanborn County,929,259,1212,670,0.76650165,0.21369637,0.552805281
South Dakota,46115,Spink County,2145,921,3139,1224,0.683338643,0.293405543,0.3899331
South Dakota,46117,Stanley County,1260,447,1735,813,0.726224784,0.257636888,0.468587896
South Dakota,46119,Sully County,716,168,901,548,0.794672586,0.186459489,0.608213097
South Dakota,46121,Todd County,497,1570,2126,-1073,0.233772342,0.738476011,-0.504703669
South Dakota,46123,Tripp County,2150,470,2654,1680,0.810097965,0.177091183,0.633006782
South Dakota,46125,Turner County,3374,1044,4538,2330,0.743499339,0.230057294,0.513442045
South Dakota,46127,Union County,6160,2548,8876,3612,0.694006309,0.287066246,0.406940063
South Dakota,46129,Walworth County,1940,481,2466,1459,0.786699108,0.195052717,0.591646391
South Dakota,46135,Yankton County,6650,3883,10832,2767,0.613921713,0.358474889,0.255446824
South Dakota,46137,Ziebach County,388,366,781,22,0.496798976,0.468629962,0.028169014
Tennessee,47001,Anderson County,24582,11525,36548,13057,0.672594944,0.315338733,0.357256211
Tennessee,47003,Bedford County,15772,4122,20090,11650,0.785067198,0.205176705,0.579890493
Tennessee,47005,Benton County,5886,1317,7260,4569,0.810743802,0.181404959,0.629338843
Tennessee,47007,Bledsoe County,5254,891,6191,4363,0.848651268,0.143918592,0.704732676
Tennessee,47009,Blount County,50699,17664,69224,33035,0.7323905,0.255171617,0.477218884
Tennessee,47011,Bradley County,38836,9852,49246,28984,0.788612273,0.200056857,0.588555416
Tennessee,47013,Campbell County,13115,2305,15528,10810,0.844603297,0.148441525,0.696161772
Tennessee,47015,Cannon County,5682,1132,6881,4550,0.825752071,0.164510972,0.661241099
Tennessee,47017,Carroll County,9547,2233,11882,7314,0.803484262,0.187931325,0.615552937
Tennessee,47019,Carter County,20167,4454,24852,15713,0.811483985,0.179220988,0.632262997
Tennessee,47021,Cheatham County,14987,5464,20741,9523,0.722578468,0.263439564,0.459138904
Tennessee,47023,Chester County,6206,1286,7577,4920,0.819057675,0.169724165,0.649333509
Tennessee,47025,Claiborne County,11463,1971,13534,9492,0.846977981,0.14563322,0.701344761
Tennessee,47027,Clay County,3117,614,3760,2503,0.828989362,0.163297872,0.665691489
Tennessee,47029,Cocke County,13105,2415,15663,10690,0.836685182,0.154185022,0.68250016
Tennessee,47031,Coffee County,19174,5440,24932,13734,0.769051821,0.218193486,0.550858335
Tennessee,47033,Crockett County,4674,1196,5921,3478,0.789393683,0.201992907,0.587400777
Tennessee,47035,Cumberland County,27399,6996,34642,20403,0.790918538,0.201951388,0.58896715
Tennessee,47037,Davidson County,102256,181862,290036,-79606,0.35256313,0.627032506,-0.274469376
Tennessee,47039,Decatur County,4596,819,5466,3777,0.840834248,0.149835346,0.690998902
Tennessee,47041,DeKalb County,7599,1706,9396,5893,0.808748404,0.181566624,0.627181779
Tennessee,47043,Dickson County,19002,5913,25204,13089,0.753927948,0.234605618,0.51932233
Tennessee,47045,Dyer County,11603,2707,14394,8896,0.806099764,0.188064471,0.618035292
Tennessee,47047,Fayette County,16756,6720,23696,10036,0.707123565,0.283592167,0.423531398
Tennessee,47049,Fentress County,8555,1149,9771,7406,0.875550097,0.117592877,0.75795722
Tennessee,47051,Franklin County,15016,4529,19728,10487,0.761151663,0.229572182,0.531579481
Tennessee,47053,Gibson County,16346,5100,21648,11246,0.755081301,0.235587583,0.519493718
Tennessee,47055,Giles County,10394,2974,13487,7420,0.770668051,0.220508638,0.550159413
Tennessee,47057,Grainger County,9630,1432,11130,8198,0.865229111,0.128661276,0.736567835
Tennessee,47059,Greene County,25586,5145,31095,20441,0.822833253,0.165460685,0.657372568
Tennessee,47061,Grundy County,5334,948,6328,4386,0.842920354,0.149810367,0.693109987
Tennessee,47063,Hamblen County,20154,5132,25501,15022,0.790321948,0.20124701,0.589074938
Tennessee,47065,Hamilton County,97195,74437,174438,22758,0.557189374,0.426724682,0.130464692
Tennessee,47067,Hancock County,2558,334,2908,2224,0.879642366,0.114855571,0.764786795
Tennessee,47069,Hardeman County,5793,3527,9399,2266,0.616342164,0.375252686,0.241089478
Tennessee,47071,Hardin County,10293,1704,12094,8589,0.851083182,0.140896312,0.71018687
Tennessee,47073,Hawkins County,22066,3987,26266,18079,0.840097464,0.151793193,0.688304272
Tennessee,47075,Haywood County,3286,3311,6652,-25,0.493986771,0.497745039,-0.003758268
Tennessee,47077,Henderson County,10083,1902,12047,8181,0.83697186,0.15788163,0.67909023
Tennessee,47079,Henry County,11629,3286,15076,8343,0.771358451,0.217962324,0.553396126
Tennessee,47081,Hickman County,8265,1968,10309,6297,0.801726647,0.190901154,0.610825492
Tennessee,47083,Houston County,2989,773,3810,2216,0.784514436,0.202887139,0.581627297
Tennessee,47085,Humphreys County,6400,1767,8264,4633,0.774443369,0.213818974,0.560624395
Tennessee,47087,Jackson County,4586,1040,5676,3546,0.807963354,0.183227625,0.624735729
Tennessee,47089,Jefferson County,21068,4503,25815,16565,0.816114662,0.174433469,0.641681193
Tennessee,47091,Johnson County,6829,1212,8102,5617,0.842878302,0.149592693,0.693285608
Tennessee,47093,Knox County,130815,87516,221864,43299,0.589617964,0.394457866,0.195160098
Tennessee,47095,Lake County,1493,429,1939,1064,0.769984528,0.221248066,0.548736462
Tennessee,47097,Lauderdale County,5633,2571,8266,3062,0.681466247,0.311033148,0.370433099
Tennessee,47099,Lawrence County,16429,2939,19533,13490,0.841089438,0.150463318,0.69062612
Tennessee,47101,Lewis County,4852,991,5890,3861,0.8237691,0.168251273,0.655517827
Tennessee,47103,Lincoln County,13208,2782,16128,10426,0.818948413,0.17249504,0.646453373
Tennessee,47105,Loudon County,25226,7625,33209,17601,0.759613358,0.229606432,0.530006926
Tennessee,47107,McMinn County,19673,4207,24072,15466,0.817256564,0.174767365,0.642489199
Tennessee,47109,McNairy County,9437,1727,11267,7710,0.83757877,0.153279489,0.684299281
Tennessee,47111,Macon County,8958,1277,10333,7681,0.866931191,0.123584632,0.74334656
Tennessee,47113,Madison County,23385,16115,39964,7270,0.585151636,0.403237914,0.181913722
Tennessee,47115,Marion County,10788,3026,13933,7762,0.774276897,0.217182229,0.557094667
Tennessee,47117,Marshall County,12426,3390,15962,9036,0.778473875,0.212379401,0.566094474
Tennessee,47119,Maury County,37376,14145,52090,23231,0.717527356,0.271549242,0.445978115
Tennessee,47121,Meigs County,5085,968,6099,4117,0.833743237,0.158714543,0.675028693
Tennessee,47123,Monroe County,18526,3608,22323,14918,0.829906375,0.161627021,0.668279353
Tennessee,47125,Montgomery County,47795,32736,81755,15059,0.584612562,0.400415877,0.184196685
Tennessee,47127,Moore County,3060,542,3654,2518,0.837438424,0.148330597,0.689107827
Tennessee,47129,Morgan County,7427,1054,8560,6373,0.867640187,0.123130841,0.744509346
Tennessee,47131,Obion County,10596,2221,12900,8375,0.821395349,0.172170543,0.649224806
Tennessee,47133,Overton County,9042,1931,11069,7111,0.81687596,0.17445117,0.64242479
Tennessee,47135,Perry County,3139,558,3716,2581,0.844725511,0.150161464,0.694564047
Tennessee,47137,Pickett County,2441,487,2954,1954,0.82633717,0.164861205,0.661475965
Tennessee,47139,Polk County,7302,1356,8727,5946,0.836713647,0.155379856,0.681333792
Tennessee,47141,Putnam County,25554,8991,34939,16563,0.731388992,0.257334211,0.474054781
Tennessee,47143,Rhea County,11974,2312,14444,9662,0.828994738,0.160066464,0.668928275
Tennessee,47145,Roane County,21011,6073,27412,14938,0.766489129,0.221545309,0.54494382
Tennessee,47147,Robertson County,26260,8428,35070,17832,0.748788138,0.240319361,0.508468777
Tennessee,47149,Rutherford County,88811,56656,147656,32155,0.601472341,0.38370266,0.217769681
Tennessee,47151,Scott County,8608,942,9605,7666,0.896199896,0.09807392,0.798125976
Tennessee,47153,Sequatchie County,6522,1292,7890,5230,0.82661597,0.163751584,0.662864385
Tennessee,47155,Sevier County,35207,8322,43970,26885,0.800705026,0.189265408,0.611439618
Tennessee,47157,Shelby County,118917,201759,326497,-82842,0.364220804,0.617950548,-0.253729743
Tennessee,47159,Smith County,7655,1595,9336,6060,0.819944302,0.170844045,0.649100257
Tennessee,47161,Stewart County,5389,1160,6620,4229,0.814048338,0.175226586,0.638821752
Tennessee,47163,Sullivan County,58154,16624,75541,41530,0.7698336,0.220065924,0.549767676
Tennessee,47165,Sumner County,68767,27874,97761,40893,0.703419564,0.285123925,0.418295639
Tennessee,47167,Tipton County,20303,6178,26733,14125,0.75947331,0.231100138,0.528373172
Tennessee,47169,Trousdale County,3359,856,4251,2503,0.79016702,0.201364385,0.588802635
Tennessee,47171,Unicoi County,6876,1578,8541,5298,0.805057956,0.184755883,0.620302072
Tennessee,47173,Union County,7384,1216,8669,6168,0.851770677,0.140269927,0.71150075
Tennessee,47175,Van Buren County,2718,524,3265,2194,0.832465544,0.160490046,0.671975498
Tennessee,47177,Warren County,13192,3647,17015,9545,0.775315898,0.214340288,0.56097561
Tennessee,47179,Washington County,42299,18131,61234,24168,0.690776366,0.296093673,0.394682693
Tennessee,47181,Wayne County,6016,762,6831,5254,0.880690968,0.111550285,0.769140682
Tennessee,47183,Weakley County,10541,2725,13394,7816,0.786994176,0.203449306,0.583544871
Tennessee,47185,White County,10717,2105,12931,8612,0.828783543,0.162787101,0.665996443
Tennessee,47187,Williamson County,94562,47695,144668,46867,0.653648353,0.329685902,0.323962452
Tennessee,47189,Wilson County,56425,23855,81254,32570,0.694427351,0.293585547,0.400841805
Texas,48001,Anderson County,15597,3635,19353,11962,0.805921563,0.187826177,0.618095386
Texas,48003,Andrews County,5205,806,6059,4399,0.859052649,0.133025252,0.726027397
Texas,48005,Angelina County,26049,8146,34419,17903,0.756820361,0.236671606,0.520148755
Texas,48007,Aransas County,10090,2831,13028,7259,0.774485723,0.217301197,0.557184526
Texas,48009,Archer County,4592,520,5132,4072,0.894777864,0.101325019,0.793452845
Texas,48011,Armstrong County,1029,77,1109,952,0.92786294,0.069431921,0.858431019
Texas,48013,Atascosa County,13142,5153,18442,7989,0.712612515,0.279416549,0.433195966
Texas,48015,Austin County,12457,2816,15379,9641,0.81000065,0.183106834,0.626893816
Texas,48017,Bailey County,1395,332,1740,1063,0.801724138,0.190804598,0.61091954
Texas,48019,Bandera County,10939,2532,13592,8407,0.804811654,0.186286051,0.618525603
Texas,48021,Bastrop County,23301,15989,39788,7312,0.585628833,0.401854831,0.183774002
Texas,48023,Baylor County,1471,184,1670,1287,0.880838323,0.110179641,0.770658683
Texas,48025,Bee County,6111,2606,8789,3505,0.695300944,0.296506997,0.398793947
Texas,48027,Bell County,75161,53973,130557,21188,0.575694907,0.413405639,0.162289268
Texas,48029,Bexar County,337545,411389,757547,-73844,0.445576314,0.543054094,-0.09747778
Texas,48031,Blanco County,6447,1973,8518,4474,0.756867809,0.231627143,0.525240667
Texas,48033,Borden County,370,16,387,354,0.956072351,0.041343669,0.914728682
Texas,48035,Bosque County,7969,1524,9571,6445,0.832619371,0.15923101,0.673388361
Texas,48037,Bowie County,27122,9282,36629,17840,0.740451555,0.253405771,0.487045783
Texas,48039,Brazoria County,95867,63976,161950,31891,0.591954307,0.395035505,0.196918802
Texas,48041,Brazos County,56671,33844,91847,22827,0.617015254,0.368482367,0.248532886
Texas,48043,Brewster County,2545,1969,4576,576,0.556162587,0.430288462,0.125874126
Texas,48045,Briscoe County,666,72,744,594,0.89516129,0.096774194,0.798387097
Texas,48047,Brooks County,1077,1308,2402,-231,0.448376353,0.544546211,-0.096169858
Texas,48049,Brown County,14593,2132,16853,12461,0.865899246,0.126505667,0.73939358
Texas,48051,Burleson County,7590,1705,9365,5885,0.810464495,0.182060865,0.628403631
Texas,48053,Burnet County,21795,6114,28147,15681,0.774327637,0.217216755,0.557110882
Texas,48055,Caldwell County,8880,6618,15686,2262,0.566109907,0.421904883,0.144205024
Texas,48057,Calhoun County,5939,1853,7832,4086,0.758299285,0.236593463,0.521705822
Texas,48059,Callahan County,6180,761,6985,5419,0.884753042,0.108947745,0.775805297
Texas,48061,Cameron County,60991,54258,116122,6733,0.525232083,0.467249961,0.057982122
Texas,48063,Camp County,4011,1201,5242,2810,0.765165967,0.229111026,0.536054941
Texas,48065,Carson County,2866,290,3172,2576,0.903530895,0.091424968,0.812105927
Texas,48067,Cass County,11693,2406,14140,9287,0.826944837,0.170155587,0.65678925
Texas,48069,Castro County,1594,418,2021,1176,0.788718456,0.206828303,0.581890153
Texas,48071,Chambers County,20567,4192,24971,16375,0.823635417,0.167874735,0.655760682
Texas,48073,Cherokee County,16593,3744,20502,12849,0.809335675,0.18261633,0.626719344
Texas,48075,Childress County,1991,263,2272,1728,0.876320423,0.115757042,0.76056338
Texas,48077,Clay County,5288,584,5906,4704,0.89536065,0.098882492,0.796478158
Texas,48079,Cochran County,735,148,893,587,0.823068309,0.165733483,0.657334826
Texas,48081,Coke County,1623,179,1814,1444,0.894707828,0.098676957,0.796030871
Texas,48083,Coleman County,3712,428,4155,3284,0.893381468,0.103008424,0.790373045
Texas,48085,Collin County,279534,222115,515167,57419,0.542608513,0.431151452,0.111457061
Texas,48087,Collingsworth County,1066,135,1201,931,0.887593672,0.112406328,0.775187344
Texas,48089,Colorado County,7824,2108,9994,5716,0.782869722,0.210926556,0.571943166
Texas,48091,Comal County,74756,27680,103465,47076,0.722524525,0.267530083,0.454994443
Texas,48093,Comanche County,5679,834,6544,4845,0.867817848,0.127444988,0.740372861
Texas,48095,Concho County,1038,153,1198,885,0.866444073,0.127712855,0.738731219
Texas,48097,Cooke County,16975,3310,20432,13665,0.83080462,0.162000783,0.668803837
Texas,48099,Coryell County,16688,6959,23911,9729,0.697921459,0.291037598,0.406883861
Texas,48101,Cottle County,565,89,657,476,0.859969559,0.135464231,0.724505327
Texas,48103,Crane County,1195,186,1387,1009,0.861571738,0.134102379,0.727469358
Texas,48105,Crockett County,1087,323,1417,764,0.76711362,0.227946366,0.539167255
Texas,48107,Crosby County,1416,451,1880,965,0.753191489,0.239893617,0.513297872
Texas,48109,Culberson County,451,319,781,132,0.577464789,0.408450704,0.169014085
Texas,48111,Dallam County,1285,152,1447,1133,0.888044229,0.105044921,0.782999309
Texas,48113,Dallas County,322569,511118,848948,-188549,0.379963202,0.602060432,-0.222097231
Texas,48115,Dawson County,2810,667,3511,2143,0.800341783,0.189974366,0.610367417
Texas,48117,Deaf Smith County,3233,1019,4286,2214,0.754316379,0.237750817,0.516565562
Texas,48119,Delta County,2250,397,2658,1853,0.846501129,0.149360421,0.697140707
Texas,48121,Denton County,250521,191503,448729,59018,0.558290193,0.426767604,0.131522589
Texas,48123,DeWitt County,6515,1270,7824,5245,0.832694274,0.162321063,0.670373211
Texas,48125,Dickens County,844,146,993,698,0.849949648,0.147029204,0.702920443
Texas,48127,Dimmit County,1653,1765,3427,-112,0.482346075,0.515027721,-0.032681646
Texas,48129,Donley County,1512,174,1712,1338,0.88317757,0.101635514,0.781542056
Texas,48131,Duval County,2439,2003,4461,436,0.546738399,0.449002466,0.097735934
Texas,48133,Eastland County,7397,918,8363,6479,0.884491211,0.109769222,0.77472199
Texas,48135,Ector County,32429,9881,42615,22548,0.760976182,0.231866714,0.529109468
Texas,48137,Edwards County,869,133,1005,736,0.864676617,0.132338308,0.732338308
Texas,48139,Ellis County,64763,33850,99485,30913,0.65098256,0.340252299,0.310730261
Texas,48141,El Paso County,105124,143156,251371,-38032,0.418202577,0.569500857,-0.15129828
Texas,48143,Erath County,15349,2871,18350,12478,0.836457766,0.156457766,0.68
Texas,48145,Falls County,4520,1713,6276,2807,0.720203952,0.272944551,0.447259401
Texas,48147,Fannin County,13648,2607,16385,11041,0.832956973,0.159108941,0.673848032
Texas,48149,Fayette County,10699,2515,13327,8184,0.802806333,0.188714639,0.614091694
Texas,48151,Fisher County,1487,330,1829,1157,0.813012575,0.180426463,0.632586113
Texas,48153,Floyd County,1715,358,2089,1357,0.82096697,0.171373863,0.649593107
Texas,48155,Foard County,448,92,545,356,0.822018349,0.168807339,0.653211009
Texas,48157,Fort Bend County,173592,179310,362259,-5718,0.479193064,0.49497735,-0.015784287
Texas,48159,Franklin County,4473,813,5310,3660,0.842372881,0.153107345,0.689265537
Texas,48161,Freestone County,7500,1499,9045,6001,0.829187396,0.165726921,0.663460475
Texas,48163,Frio County,3060,1848,4933,1212,0.620312183,0.374619907,0.245692277
Texas,48165,Gaines County,5840,538,6416,5302,0.910224439,0.083852868,0.826371571
Texas,48167,Galveston County,100295,56732,158933,43563,0.631052079,0.356955447,0.274096632
Texas,48169,Garza County,1374,213,1599,1161,0.859287054,0.133208255,0.726078799
Texas,48171,Gillespie County,13202,3160,16482,10042,0.800995025,0.191724305,0.60927072
Texas,48173,Glasscock County,623,38,663,585,0.939668175,0.057315234,0.882352941
Texas,48175,Goliad County,3178,778,3984,2400,0.797690763,0.195281124,0.602409639
Texas,48177,Gonzales County,5981,1729,7755,4252,0.771244358,0.222952934,0.548291425
Texas,48179,Gray County,6691,845,7580,5846,0.882717678,0.111477573,0.771240106
Texas,48181,Grayson County,50556,14800,65888,35756,0.767302088,0.224623604,0.542678485
Texas,48183,Gregg County,33026,13294,46699,19732,0.707210004,0.28467419,0.422535814
Texas,48185,Grimes County,11197,2734,14043,8463,0.797336751,0.194687745,0.602649007
Texas,48187,Guadalupe County,54691,29573,85097,25118,0.642690107,0.347521064,0.295169042
Texas,48189,Hale County,7283,1903,9278,5380,0.78497521,0.20510886,0.579866351
Texas,48191,Hall County,992,149,1149,843,0.863359443,0.129677981,0.733681462
Texas,48193,Hamilton County,3809,625,4464,3184,0.853270609,0.140008961,0.713261649
Texas,48195,Hansford County,1842,146,1999,1696,0.92146073,0.073036518,0.848424212
Texas,48197,Hardeman County,1210,188,1405,1022,0.861209964,0.133807829,0.727402135
Texas,48199,Hardin County,24691,3347,28157,21344,0.8769045,0.118869198,0.758035302
Texas,48201,Harris County,722695,808771,1556310,-86076,0.464364426,0.519672173,-0.055307747
Texas,48203,Harrison County,22658,7369,30226,15289,0.749619533,0.243796731,0.505822802
Texas,48205,Hartley County,1843,163,2016,1680,0.914186508,0.080853175,0.833333333
Texas,48207,Haskell County,1918,313,2246,1605,0.8539626,0.13935886,0.71460374
Texas,48209,Hays County,58438,65528,125688,-7090,0.464944943,0.521354465,-0.056409522
Texas,48211,Hemphill County,1412,190,1612,1222,0.875930521,0.117866005,0.758064516
Texas,48213,Henderson County,31379,6919,38528,24460,0.814446636,0.179583679,0.634862957
Texas,48215,Hidalgo County,110760,104517,217194,6243,0.509958839,0.481214951,0.028743888
Texas,48217,Hill County,13669,2919,16703,10750,0.818355984,0.174759025,0.643596959
Texas,48219,Hockley County,6616,1323,7987,5293,0.828346062,0.165644172,0.662701891
Texas,48221,Hood County,30174,6070,36538,24104,0.825825168,0.166128414,0.659696754
Texas,48223,Hopkins County,13754,2917,16773,10837,0.820008347,0.173910451,0.646097895
Texas,48225,Houston County,7247,2065,9362,5182,0.774086734,0.220572527,0.553514206
Texas,48227,Howard County,7817,1759,9640,6058,0.810892116,0.18246888,0.628423237
Texas,48229,Hudspeth County,759,275,1038,484,0.731213873,0.264932563,0.46628131
Texas,48231,Hunt County,36137,10212,46703,25925,0.773761857,0.21865833,0.555103527
Texas,48233,Hutchinson County,7273,913,8241,6360,0.882538527,0.110787526,0.771751001
Texas,48235,Irion County,761,105,868,656,0.876728111,0.120967742,0.755760369
Texas,48237,Jack County,3819,363,4201,3456,0.909069269,0.086407998,0.822661271
Texas,48239,Jackson County,5386,907,6329,4479,0.851003318,0.14330858,0.707694739
Texas,48241,Jasper County,13162,2615,15839,10547,0.830986805,0.165098807,0.665887998
Texas,48243,Jeff Davis County,699,450,1169,249,0.597946963,0.384944397,0.213002566
Texas,48245,Jefferson County,46596,38936,86272,7660,0.540105712,0.451316766,0.088788947
Texas,48247,Jim Hogg County,725,856,1585,-131,0.457413249,0.540063091,-0.082649842
Texas,48249,Jim Wells County,7636,5577,13268,2059,0.575520048,0.42033464,0.155185409
Texas,48251,Johnson County,60752,19247,80691,41505,0.752896853,0.238527221,0.514369632
Texas,48253,Jones County,5988,907,6946,5081,0.862078894,0.13057875,0.731500144
Texas,48255,Karnes County,4001,1051,5075,2950,0.788374384,0.207093596,0.581280788
Texas,48257,Kaufman County,44063,24726,69366,19337,0.63522475,0.356457054,0.278767696
Texas,48259,Kendall County,22668,6355,29295,16313,0.773783922,0.216931217,0.556852705
Texas,48261,Kenedy County,115,41,158,74,0.727848101,0.259493671,0.46835443
Texas,48263,Kent County,390,50,445,340,0.876404494,0.112359551,0.764044944
Texas,48265,Kerr County,21615,6315,28156,15300,0.767687171,0.22428612,0.543401051
Texas,48267,Kimble County,2126,261,2402,1865,0.885095754,0.10865945,0.776436303
Texas,48269,King County,129,6,135,123,0.955555556,0.044444444,0.911111111
Texas,48271,Kinney County,1063,346,1419,717,0.749119098,0.243833686,0.505285412
Texas,48273,Kleberg County,5612,4338,10010,1274,0.560639361,0.433366633,0.127272727
Texas,48275,Knox County,1156,214,1376,942,0.840116279,0.155523256,0.684593023
Texas,48277,Lamar County,17044,4079,21236,12965,0.80259936,0.192079488,0.610519872
Texas,48279,Lamb County,3398,729,4151,2669,0.818597928,0.175620332,0.642977596
Texas,48281,Lampasas County,8961,2232,11296,6729,0.79328966,0.197592068,0.595697592
Texas,48283,La Salle County,1417,933,2360,484,0.600423729,0.395338983,0.205084746
Texas,48285,Lavaca County,9215,1235,10486,7980,0.878790769,0.117776082,0.761014686
Texas,48287,Lee County,6724,1640,8413,5084,0.799239273,0.194936408,0.604302865
Texas,48289,Leon County,7982,1033,9060,6949,0.881015453,0.11401766,0.766997792
Texas,48291,Liberty County,25241,5952,31316,19289,0.806009707,0.190062588,0.61594712
Texas,48293,Limestone County,7081,1921,9069,5160,0.780791708,0.211820487,0.568971221
Texas,48295,Lipscomb County,1125,123,1259,1002,0.893566322,0.097696585,0.795869738
Texas,48297,Live Oak County,4307,761,5092,3546,0.845836606,0.149450118,0.696386489
Texas,48299,Llano County,10902,2613,13622,8289,0.800323007,0.191822053,0.608500954
Texas,48301,Loving County,86,10,97,76,0.886597938,0.103092784,0.783505155
Texas,48303,Lubbock County,86547,37148,124972,49399,0.692531127,0.297250584,0.395280543
Texas,48305,Lynn County,2175,371,2567,1804,0.847292559,0.144526685,0.702765875
Texas,48307,McCulloch County,3033,455,3513,2578,0.863364646,0.12951893,0.733845716
Texas,48309,McLennan County,64606,33863,99490,30743,0.649371796,0.340365866,0.30900593
Texas,48311,McMullen County,448,37,487,411,0.919917864,0.075975359,0.843942505
Texas,48313,Madison County,4498,964,5489,3534,0.819457096,0.175623975,0.643833121
Texas,48315,Marion County,3577,1101,4714,2476,0.758803564,0.23355961,0.525243954
Texas,48317,Martin County,1825,247,2083,1578,0.876140182,0.118578973,0.75756121
Texas,48319,Mason County,2076,434,2526,1642,0.821852732,0.171813143,0.650039588
Texas,48321,Matagorda County,9957,3231,13308,6726,0.748196573,0.242786294,0.50541028
Texas,48323,Maverick County,9285,6373,15743,2912,0.589785937,0.404814838,0.184971098
Texas,48325,Medina County,17464,6950,24598,10514,0.709976421,0.282543296,0.427433125
Texas,48327,Menard County,861,170,1039,691,0.828681424,0.163618864,0.66506256
Texas,48329,Midland County,46944,11351,58800,35593,0.798367347,0.193044218,0.605323129
Texas,48331,Milam County,8691,2331,11093,6360,0.783467051,0.210132516,0.573334535
Texas,48333,Mills County,2418,310,2741,2108,0.882159796,0.11309741,0.769062386
Texas,48335,Mitchell County,2144,352,2513,1792,0.85316355,0.140071628,0.713091922
Texas,48337,Montague County,9825,1208,11097,8617,0.885374426,0.10885825,0.776516176
Texas,48339,Montgomery County,221964,82277,307134,139687,0.722694329,0.26788633,0.454807999
Texas,48341,Moore County,4458,860,5359,3598,0.831871618,0.160477701,0.671393917
Texas,48343,Morris County,4092,1312,5433,2780,0.753175041,0.241487208,0.511687834
Texas,48345,Motley County,612,35,650,577,0.941538462,0.053846154,0.887692308
Texas,48347,Nacogdoches County,17575,7690,25470,9885,0.690027483,0.301923832,0.388103651
Texas,48349,Navarro County,14983,4708,19829,10275,0.75561047,0.237430027,0.518180443
Texas,48351,Newton County,4781,952,5749,3829,0.831622891,0.165594016,0.666028875
Texas,48353,Nolan County,4048,1020,5114,3028,0.791552601,0.199452483,0.592100117
Texas,48355,Nueces County,67201,53248,121614,13953,0.552576184,0.437844327,0.114731857
Texas,48357,Ochiltree County,2723,269,3008,2454,0.90525266,0.089428191,0.815824468
Texas,48359,Oldham County,895,74,974,821,0.91889117,0.075975359,0.842915811
Texas,48361,Orange County,30191,5945,36328,24246,0.831066946,0.163647875,0.667419071
Texas,48363,Palo Pinto County,11093,2143,13333,8950,0.8319958,0.160729018,0.671266782
Texas,48365,Panola County,9500,1905,11437,7595,0.830637405,0.166564659,0.664072746
Texas,48367,Parker County,75168,14872,90802,60296,0.827823176,0.163784939,0.664038237
Texas,48369,Parmer County,2123,368,2504,1755,0.84784345,0.146964856,0.700878594
Texas,48371,Pecos County,3042,1144,4233,1898,0.718639263,0.270257501,0.448381762
Texas,48373,Polk County,19216,4910,24285,14306,0.791270331,0.202182417,0.589087914
Texas,48375,Potter County,23007,8748,32091,14259,0.71692998,0.272599794,0.444330186
Texas,48377,Presidio County,686,1289,1994,-603,0.344032096,0.646439318,-0.302407222
Texas,48379,Rains County,5649,869,6554,4780,0.861916387,0.132590784,0.729325603
Texas,48381,Randall County,53314,12935,66854,40379,0.797469112,0.193481317,0.603987794
Texas,48383,Reagan County,800,141,949,659,0.842992624,0.14857745,0.694415174
Texas,48385,Real County,1625,315,1958,1310,0.829928498,0.160878447,0.669050051
Texas,48387,Red River County,4682,1103,5796,3579,0.807798482,0.190303658,0.617494824
Texas,48389,Reeves County,2340,1070,3439,1270,0.680430358,0.311136958,0.369293399
Texas,48391,Refugio County,2134,919,3072,1215,0.694661458,0.299153646,0.395507813
Texas,48393,Roberts County,547,20,570,527,0.959649123,0.035087719,0.924561404
Texas,48395,Robertson County,6177,1926,8154,4251,0.757542311,0.236203091,0.52133922
Texas,48397,Rockwall County,43542,18092,62251,25450,0.699458643,0.290629869,0.408828774
Texas,48399,Runnels County,3580,452,4056,3128,0.882642998,0.111439842,0.771203156
Texas,48401,Rusk County,17234,4337,21702,12897,0.794120358,0.199843332,0.594277025
Texas,48403,Sabine County,4972,590,5581,4382,0.890879771,0.105715822,0.785163949
Texas,48405,San Augustine County,2917,809,3747,2108,0.778489458,0.215906058,0.5625834
Texas,48407,San Jacinto County,10524,2175,12789,8349,0.822894675,0.170068027,0.652826648
Texas,48409,San Patricio County,17337,8025,25572,9312,0.67796809,0.313819803,0.364148287
Texas,48411,San Saba County,2412,276,2703,2136,0.892341842,0.102108768,0.790233074
Texas,48413,Schleicher County,906,192,1108,714,0.817689531,0.173285199,0.644404332
Texas,48415,Scurry County,4945,734,5720,4211,0.86451049,0.128321678,0.736188811
Texas,48417,Shackelford County,1565,146,1727,1419,0.906195715,0.084539664,0.821656051
Texas,48419,Shelby County,8164,1741,9948,6423,0.820667471,0.175010052,0.645657419
Texas,48421,Sherman County,817,48,872,769,0.936926606,0.055045872,0.881880734
Texas,48423,Smith County,74862,28041,103815,46821,0.721109666,0.270105476,0.45100419
Texas,48425,Somervell County,4493,751,5285,3742,0.850141911,0.142100284,0.708041627
Texas,48427,Starr County,9487,6862,16419,2625,0.5778062,0.417930446,0.159875754
Texas,48429,Stephens County,3368,384,3761,2984,0.895506514,0.102100505,0.793406009
Texas,48431,Sterling County,583,43,629,540,0.926868045,0.06836248,0.858505564
Texas,48433,Stonewall County,604,110,716,494,0.843575419,0.153631285,0.689944134
Texas,48435,Sutton County,1167,228,1400,939,0.833571429,0.162857143,0.670714286
Texas,48437,Swisher County,1840,403,2265,1437,0.812362031,0.177924945,0.634437086
Texas,48439,Tarrant County,426626,384501,822680,42125,0.518580736,0.467376137,0.0512046
Texas,48441,Taylor County,41198,13624,55386,27574,0.743834182,0.245982739,0.497851443
Texas,48443,Terrell County,314,91,405,223,0.775308642,0.224691358,0.550617284
Texas,48445,Terry County,2815,587,3419,2228,0.823340158,0.171687628,0.65165253
Texas,48447,Throckmorton County,823,73,900,750,0.914444444,0.081111111,0.833333333
Texas,48449,Titus County,7861,2275,10208,5586,0.770082288,0.22286442,0.547217868
Texas,48451,Tom Green County,33399,11585,45438,21814,0.735045557,0.254962806,0.48008275
Texas,48453,Travis County,170787,398981,580285,-228194,0.294315724,0.687560423,-0.393244699
Texas,48455,Trinity County,6136,1195,7374,4941,0.832112829,0.162055872,0.670056957
Texas,48457,Tyler County,8286,1249,9577,7037,0.86519787,0.130416623,0.734781247
Texas,48459,Upshur County,16939,2820,19882,14119,0.851976662,0.141836837,0.710139825
Texas,48461,Upton County,1149,146,1303,1003,0.881811205,0.112049117,0.769762087
Texas,48463,Uvalde County,6482,3218,9769,3264,0.663527485,0.329409356,0.334118129
Texas,48465,Val Verde County,9162,5282,14578,3880,0.628481273,0.362326794,0.266154479
Texas,48467,Van Zandt County,24351,3450,27935,20901,0.871702166,0.123500984,0.748201181
Texas,48469,Victoria County,25010,9998,35239,15012,0.709725021,0.283719742,0.426005278
Texas,48471,Walker County,17515,7461,25170,10054,0.695868097,0.296424315,0.399443782
Texas,48473,Waller County,17077,10183,27545,6894,0.619967326,0.369685968,0.250281358
Texas,48475,Ward County,3115,627,3764,2488,0.827577046,0.166578108,0.660998937
Texas,48477,Washington County,14020,4058,18208,9962,0.769991213,0.222869069,0.547122144
Texas,48479,Webb County,33384,31952,65845,1432,0.507008885,0.48526084,0.021748045
Texas,48481,Wharton County,12439,3910,16452,8529,0.756078288,0.237661075,0.518417214
Texas,48483,Wheeler County,2093,169,2272,1924,0.921214789,0.074383803,0.846830986
Texas,48485,Wichita County,31818,12237,44497,19581,0.715059442,0.275007304,0.440052138
Texas,48487,Wilbarger County,3566,860,4463,2706,0.799014116,0.192695496,0.60631862
Texas,48489,Willacy County,2856,2673,5563,183,0.513392055,0.480496135,0.032895919
Texas,48491,Williamson County,155310,147766,308163,7544,0.503986527,0.479505976,0.024480551
Texas,48493,Wilson County,20894,6247,27270,14647,0.766189952,0.229079575,0.537110378
Texas,48495,Winkler County,1646,283,1932,1363,0.851966874,0.146480331,0.705486542
Texas,48497,Wise County,32385,5605,38230,26780,0.8471096,0.146612608,0.700496992
Texas,48499,Wood County,20621,3618,24381,17003,0.845781551,0.148394241,0.69738731
Texas,48501,Yoakum County,2039,342,2393,1697,0.852068533,0.142916841,0.709151692
Texas,48503,Young County,7298,962,8309,6336,0.878324708,0.115778072,0.762546636
Texas,48505,Zapata County,2970,1877,4871,1093,0.609731061,0.385341819,0.224389242
Texas,48507,Zavala County,1482,1984,3492,-502,0.424398625,0.568155785,-0.143757159
Utah,49001,Beaver County,2781,394,3212,2387,0.865815691,0.122665006,0.743150685
Utah,49003,Box Elder County,22853,5274,28909,17579,0.790515065,0.182434536,0.608080529
Utah,49005,Cache County,39457,18718,60229,20739,0.655116306,0.310780521,0.344335785
Utah,49007,Carbon County,6719,2525,9445,4194,0.711381683,0.267337215,0.444044468
Utah,49009,Daggett County,443,101,550,342,0.805454545,0.183636364,0.621818182
Utah,49011,Davis County,101293,59895,166492,41398,0.608395599,0.359747015,0.248648584
Utah,49013,Duchesne County,7815,1009,8967,6806,0.871528939,0.112523698,0.759005241
Utah,49015,Emery County,4341,603,5011,3738,0.866294153,0.120335262,0.74595889
Utah,49017,Garfield County,2211,541,2811,1670,0.786552828,0.1924582,0.594094628
Utah,49019,Grand County,2327,2828,5300,-501,0.439056604,0.533584906,-0.094528302
Utah,49021,Iron County,21571,5683,27876,15888,0.773819773,0.203867126,0.569952647
Utah,49023,Juab County,5671,734,6518,4937,0.870052163,0.11261123,0.757440933
Utah,49025,Kane County,3277,1137,4486,2140,0.730494873,0.253455194,0.477039679
Utah,49027,Millard County,5558,713,6385,4845,0.870477682,0.111667972,0.75880971
Utah,49029,Morgan County,5300,1256,6757,4044,0.784371763,0.185881308,0.598490454
Utah,49031,Piute County,854,94,963,760,0.886812046,0.09761163,0.789200415
Utah,49033,Rich County,1211,214,1447,997,0.836903939,0.147892191,0.689011748
Utah,49035,Salt Lake County,221555,273658,509492,-52103,0.434854718,0.537119327,-0.102264609
Utah,49037,San Juan County,3613,2581,6328,1032,0.570954488,0.407869785,0.163084703
Utah,49039,Sanpete County,10653,1906,12943,8747,0.823070386,0.147261068,0.675809318
Utah,49041,Sevier County,9526,1236,10926,8290,0.871865275,0.113124657,0.758740619
Utah,49043,Summit County,10783,14612,25876,-3829,0.416718194,0.564693152,-0.147974957
Utah,49045,Tooele County,23484,9560,33988,13924,0.690949747,0.281275744,0.409674003
Utah,49047,Uintah County,13599,1952,15831,11647,0.859010802,0.123302381,0.73570842
Utah,49049,Utah County,203476,84937,297944,118539,0.682933706,0.285077061,0.397856644
Utah,49051,Wasatch County,11495,6459,18354,5036,0.626293996,0.35191239,0.274381606
Utah,49053,Washington County,73165,22327,97243,50838,0.752393488,0.229600074,0.522793414
Utah,49055,Wayne County,1238,381,1651,857,0.749848577,0.230769231,0.519079346
Utah,49057,Weber County,67549,41238,112017,26311,0.603024541,0.36814055,0.234883991
Vermont,50001,Addison County,6841,14879,22396,-8038,0.305456331,0.664359707,-0.358903376
Vermont,50003,Bennington County,7697,12326,20552,-4629,0.374513429,0.599746983,-0.225233554
Vermont,50005,Caledonia County,6927,8977,16482,-2050,0.420276665,0.544654775,-0.124378109
Vermont,50007,Chittenden County,20937,72656,96405,-51719,0.217177532,0.753653856,-0.536476324
Vermont,50009,Essex County,1890,1344,3410,546,0.554252199,0.394134897,0.160117302
Vermont,50011,Franklin County,12490,13280,26552,-790,0.47039771,0.500150648,-0.029752938
Vermont,50013,Grand Isle County,1893,2940,4967,-1047,0.381115361,0.591906583,-0.210791222
Vermont,50015,Lamoille County,4505,9788,14757,-5283,0.305278851,0.663278444,-0.357999593
Vermont,50017,Orange County,6683,10220,17536,-3537,0.381101734,0.582801095,-0.201699361
Vermont,50019,Orleans County,7233,7006,14655,227,0.493551689,0.478062095,0.015489594
Vermont,50021,Rutland County,15586,17375,33883,-1789,0.459994688,0.512794027,-0.052799339
Vermont,50023,Washington County,9327,24527,35058,-15200,0.26604484,0.699612071,-0.433567231
Vermont,50025,Windham County,6928,17904,25718,-10976,0.269383311,0.696166109,-0.426782798
Vermont,50027,Windsor County,10458,22569,34018,-12111,0.307425481,0.663442883,-0.356017403
Virginia,51001,Accomack County,9659,7374,17144,2285,0.563404106,0.430121325,0.133282781
Virginia,51003,Albemarle County,21513,44279,66740,-22766,0.322340426,0.663455199,-0.341114774
Virginia,51005,Alleghany County,6093,2114,8277,3979,0.736136281,0.255406548,0.480729733
Virginia,51007,Amelia County,5776,2214,8032,3562,0.719123506,0.27564741,0.443476096
Virginia,51009,Amherst County,11742,5429,17303,6313,0.678610646,0.31376062,0.364850026
Virginia,51011,Appomattox County,7243,2324,9642,4919,0.751192699,0.241028832,0.510163866
Virginia,51013,Arlington County,25223,100446,128362,-75223,0.196498964,0.782521307,-0.586022343
Virginia,51015,Augusta County,32429,11403,44223,21026,0.733306198,0.257852249,0.475453949
Virginia,51017,Bath County,1976,588,2582,1388,0.765298218,0.227730442,0.537567777
Virginia,51019,Bedford County,38017,12414,50830,25603,0.747924454,0.244225851,0.503698603
Virginia,51021,Bland County,2998,524,3548,2474,0.844983089,0.147688839,0.69729425
Virginia,51023,Botetourt County,15796,5915,21893,9881,0.721509158,0.270177682,0.451331476
Virginia,51025,Brunswick County,3523,4184,7738,-661,0.455285604,0.540708193,-0.08542259
Virginia,51027,Buchanan County,7939,1355,9327,6584,0.851184732,0.145277152,0.70590758
Virginia,51029,Buckingham County,4847,2988,7915,1859,0.612381554,0.377511055,0.234870499
Virginia,51031,Campbell County,23032,7890,31171,15142,0.738891919,0.253119887,0.485772032
Virginia,51033,Caroline County,9511,7957,17653,1554,0.538775279,0.450744916,0.088030363
Virginia,51035,Carroll County,13152,2925,16160,10227,0.813861386,0.181002475,0.632858911
Virginia,51036,Charles City County,1917,2384,4341,-467,0.441603317,0.549182216,-0.107578899
Virginia,51037,Charlotte County,3963,2008,6006,1955,0.65984016,0.334332334,0.325507826
Virginia,51041,Chesterfield County,94030,112869,209730,-18839,0.44833834,0.538163353,-0.089825013
Virginia,51043,Clarke County,5641,3993,9782,1648,0.576671437,0.408198732,0.168472705
Virginia,51045,Craig County,2562,542,3121,2020,0.82089074,0.173662288,0.647228452
Virginia,51047,Culpeper County,17685,10557,28553,7128,0.619374497,0.369733478,0.249641018
Virginia,51049,Cumberland County,3335,2117,5486,1218,0.607911046,0.38589136,0.222019686
Virginia,51051,Dickenson County,5701,1316,7047,4385,0.808996736,0.186746133,0.622250603
Virginia,51053,Dinwiddie County,9549,5942,15589,3607,0.612547309,0.381166207,0.231381102
Virginia,51057,Essex County,3245,2775,6064,470,0.53512533,0.457618734,0.077506596
Virginia,51059,Fairfax County,181895,386438,584387,-204543,0.31125778,0.661270699,-0.35001292
Virginia,51061,Fauquier County,26825,17180,44537,9645,0.602308193,0.385746683,0.216561511
Virginia,51063,Floyd County,6551,2968,9625,3583,0.680623377,0.308363636,0.37225974
Virginia,51065,Fluvanna County,8777,7731,16678,1046,0.526262142,0.46354479,0.062717352
Virginia,51067,Franklin County,22319,8321,30912,13998,0.72201734,0.269183489,0.452833851
Virginia,51069,Frederick County,33117,18331,52040,14786,0.636375865,0.352248271,0.284127594
Virginia,51071,Giles County,7102,2069,9234,5033,0.769114143,0.224063245,0.545050899
Virginia,51073,Gloucester County,15918,7034,23149,8884,0.687632295,0.303857618,0.383774677
Virginia,51075,Goochland County,11521,7875,19616,3646,0.587326672,0.401457993,0.185868679
Virginia,51077,Grayson County,6544,1503,8104,5041,0.807502468,0.185463968,0.6220385
Virginia,51079,Greene County,7432,4456,12038,2976,0.617378302,0.370161156,0.247217146
Virginia,51081,Greensville County,1936,2334,4296,-398,0.450651769,0.543296089,-0.09264432
Virginia,51083,Halifax County,10741,6984,17844,3757,0.601939027,0.391392065,0.210546963
Virginia,51085,Hanover County,45569,26733,73087,18836,0.623489814,0.365769562,0.257720251
Virginia,51087,Henrico County,62882,115040,180642,-52158,0.348102878,0.636839716,-0.288736839
Virginia,51089,Henry County,16800,8457,25413,8343,0.661078975,0.332782434,0.328296541
Virginia,51091,Highland County,1095,416,1529,679,0.716154349,0.27207325,0.444081099
Virginia,51093,Isle of Wight County,14659,9779,24672,4880,0.594155318,0.396360246,0.197795071
Virginia,51095,James City County,23575,26742,50892,-3167,0.463235872,0.525465692,-0.06222982
Virginia,51097,King and Queen County,2608,1536,4173,1072,0.624970046,0.368080518,0.256889528
Virginia,51099,King George County,9500,5657,15362,3843,0.618409061,0.368246322,0.250162739
Virginia,51101,King William County,8080,3388,11561,4692,0.698901479,0.293054234,0.405847245
Virginia,51103,Lancaster County,3866,3355,7279,511,0.531116912,0.460914961,0.070201951
Virginia,51105,Lee County,8674,1391,10108,7283,0.858132173,0.137613771,0.720518401
Virginia,51107,Loudoun County,92107,129280,228208,-37173,0.403609865,0.566500736,-0.162890871
Virginia,51109,Louisa County,15084,8779,24067,6305,0.626750322,0.364773341,0.261976981
Virginia,51111,Lunenburg County,3594,2253,5879,1341,0.611328457,0.38322844,0.228100017
Virginia,51113,Madison County,5671,2700,8439,2971,0.671999052,0.319943121,0.352055931
Virginia,51115,Mathews County,4106,1774,5929,2332,0.692528251,0.299207286,0.393320965
Virginia,51117,Mecklenburg County,9791,6404,16266,3387,0.601930407,0.39370466,0.208225747
Virginia,51119,Middlesex County,4357,2473,6882,1884,0.633100843,0.359343214,0.273757629
Virginia,51121,Montgomery County,22179,23811,46767,-1632,0.47424466,0.509141061,-0.034896401
Virginia,51125,Nelson County,5004,4298,9388,706,0.533020878,0.457818492,0.075202386
Virginia,51127,New Kent County,10974,5641,16744,5333,0.655398949,0.336896799,0.31850215
Virginia,51131,Northampton County,3183,3603,6832,-420,0.465895785,0.527371194,-0.06147541
Virginia,51133,Northumberland County,4938,3202,8205,1736,0.601828154,0.390249848,0.211578306
Virginia,51135,Nottoway County,4168,2636,6853,1532,0.608200788,0.384649059,0.223551729
Virginia,51137,Orange County,13764,8274,22247,5490,0.61869016,0.371915314,0.246774846
Virginia,51139,Page County,10123,2976,13211,7147,0.766255393,0.225266823,0.54098857
Virginia,51141,Patrick County,7746,1886,9698,5860,0.798721386,0.194473087,0.604248299
Virginia,51143,Pittsylvania County,24310,9599,34100,14711,0.712903226,0.281495601,0.431407625
Virginia,51145,Powhatan County,14918,5734,20841,9184,0.715800585,0.275130752,0.440669834
Virginia,51147,Prince Edward County,4782,4539,9424,243,0.507427844,0.481642615,0.025785229
Virginia,51149,Prince George County,10590,6842,17596,3748,0.601841328,0.388838372,0.213002955
Virginia,51153,Prince William County,90203,131128,227591,-40925,0.396338168,0.576156351,-0.179818183
Virginia,51155,Pulaski County,12732,4830,17690,7902,0.71972866,0.273035613,0.446693047
Virginia,51157,Rappahannock County,2943,2041,5038,902,0.584160381,0.40512108,0.179039301
Virginia,51159,Richmond County,2697,1439,4161,1258,0.6481615,0.345830329,0.30233117
Virginia,51161,Roanoke County,34453,21693,56789,12760,0.606684393,0.381992992,0.224691402
Virginia,51163,Rockbridge County,8468,4160,12752,4308,0.664052698,0.326223338,0.33782936
Virginia,51165,Rockingham County,33033,15035,48581,17998,0.679957185,0.309483131,0.370474054
Virginia,51167,Russell County,11303,2172,13525,9131,0.835711645,0.160591497,0.675120148
Virginia,51169,Scott County,9392,1607,11057,7785,0.849416659,0.145337795,0.704078864
Virginia,51171,Shenandoah County,17215,6914,24380,10301,0.706111567,0.283593109,0.422518458
Virginia,51173,Smyth County,11521,2805,14420,8716,0.798959778,0.194521498,0.60443828
Virginia,51175,Southampton County,6133,3626,9831,2507,0.623842946,0.368833282,0.255009663
Virginia,51177,Spotsylvania County,42531,35747,79209,6784,0.536946559,0.451299726,0.085646833
Virginia,51179,Stafford County,40590,41252,83123,-662,0.488312501,0.496276602,-0.007964101
Virginia,51181,Surry County,2205,2176,4429,29,0.497855046,0.491307293,0.006547753
Virginia,51183,Sussex County,2322,2539,4892,-217,0.474652494,0.51901063,-0.044358136
Virginia,51185,Tazewell County,16711,3030,19858,13681,0.841524826,0.152583342,0.688941485
Virginia,51187,Warren County,15400,6910,22561,8490,0.682593857,0.30628075,0.376313107
Virginia,51191,Washington County,22455,6772,29412,15683,0.763463892,0.230246158,0.533217734
Virginia,51193,Westmoreland County,6003,4491,10581,1512,0.567337681,0.424440034,0.142897647
Virginia,51195,Wise County,13655,3036,16776,10619,0.81396042,0.180972818,0.632987601
Virginia,51197,Wythe County,12267,3075,15439,9192,0.794546279,0.199170931,0.595375348
Virginia,51199,York County,20722,18296,39540,2426,0.524076884,0.462721295,0.061355589
Virginia,51510,Alexandria city,16112,62326,80062,-46214,0.201244036,0.778471684,-0.577227649
Virginia,51520,Bristol city,5197,2231,7479,2966,0.694878995,0.298301912,0.396577082
Virginia,51530,Buena Vista city,2035,767,2853,1268,0.713284262,0.268839818,0.444444444
Virginia,51540,Charlottesville city,3428,19435,23303,-16007,0.147105523,0.834012788,-0.686907265
Virginia,51550,Chesapeake city,60550,65399,127493,-4849,0.474928035,0.512961496,-0.038033461
Virginia,51570,Colonial Heights city,5883,2982,8941,2901,0.657980092,0.333519741,0.324460351
Virginia,51580,Covington city,1642,818,2475,824,0.663434343,0.330505051,0.332929293
Virginia,51590,Danville city,6894,10615,17667,-3721,0.390219052,0.60083772,-0.210618668
Virginia,51595,Emporia city,744,1419,2178,-675,0.341597796,0.651515152,-0.309917355
Virginia,51600,Fairfax city,4302,8797,13445,-4495,0.319970249,0.654295277,-0.334325028
Virginia,51610,Falls Church city,1620,7200,8969,-5580,0.180622143,0.80276508,-0.622142937
Virginia,51620,Franklin city,1476,2359,3876,-883,0.380804954,0.608617131,-0.227812178
Virginia,51630,Fredericksburg city,4480,8760,13495,-4280,0.331974805,0.649129307,-0.317154502
Virginia,51640,Galax city,1946,753,2717,1193,0.716231137,0.277143909,0.439087229
Virginia,51650,Hampton city,18383,43357,62632,-24974,0.293508111,0.692249968,-0.398741857
Virginia,51660,Harrisonburg city,6266,10641,17245,-4375,0.363351696,0.61704842,-0.253696724
Virginia,51670,Hopewell city,3838,5078,9006,-1240,0.426160338,0.563846325,-0.137685987
Virginia,51678,Lexington city,1030,1795,2863,-765,0.359762487,0.626964722,-0.267202235
Virginia,51680,Lynchburg city,19574,16664,36715,2910,0.533133597,0.453874438,0.079259158
Virginia,51683,Manassas city,6670,9048,16021,-2378,0.416328569,0.564758754,-0.148430185
Virginia,51685,Manassas Park city,2314,3506,5967,-1192,0.387799564,0.587564941,-0.199765376
Virginia,51690,Martinsville city,2155,3435,5658,-1280,0.380876635,0.607104984,-0.226228349
Virginia,51700,Newport News city,26385,48169,75629,-21784,0.348874109,0.636911767,-0.288037658
Virginia,51710,Norfolk city,24377,59941,85643,-35564,0.284635055,0.699893745,-0.41525869
Virginia,51720,Norton city,1174,458,1643,716,0.714546561,0.278758369,0.435788192
Virginia,51730,Petersburg city,1702,11219,13077,-9517,0.130152176,0.857918483,-0.727766307
Virginia,51735,Poquoson city,5800,2119,8024,3681,0.722831505,0.264082752,0.458748754
Virginia,51740,Portsmouth city,12370,28306,41252,-15936,0.299864249,0.686172792,-0.386308543
Virginia,51750,Radford city,3197,3231,6550,-34,0.488091603,0.493282443,-0.00519084
Virginia,51760,Richmond city,17041,88710,108143,-71669,0.157578392,0.820302747,-0.662724356
Virginia,51770,Roanoke city,15787,25737,42128,-9950,0.374738891,0.610923851,-0.23618496
Virginia,51775,Salem city,7769,5237,13148,2532,0.590888348,0.39831153,0.192576818
Virginia,51790,Staunton city,5778,7592,13562,-1814,0.426043356,0.55979944,-0.133756083
Virginia,51800,Suffolk city,22112,30597,53352,-8485,0.414454941,0.573493027,-0.159038087
Virginia,51810,Virginia Beach city,109375,115412,227770,-6037,0.480199324,0.506704131,-0.026504807
Virginia,51820,Waynesboro city,5882,5240,11274,642,0.521731417,0.464786234,0.056945184
Virginia,51830,Williamsburg city,2119,5613,7851,-3494,0.269901923,0.714940772,-0.445038849
Virginia,51840,Winchester city,5252,6407,11822,-1155,0.444256471,0.541955676,-0.097699205
Washington,53001,Adams County,3767,1455,5345,2312,0.704770814,0.272217025,0.432553789
Washington,53003,Asotin County,7004,4082,11396,2922,0.614601615,0.358195858,0.256405756
Washington,53005,Benton County,59555,37662,99947,21893,0.595865809,0.376819714,0.219046094
Washington,53007,Chelan County,22363,18397,41893,3966,0.533812331,0.439142578,0.094669754
Washington,53009,Clallam County,21632,25440,48390,-3808,0.447034511,0.525728456,-0.078693945
Washington,53011,Clark County,123998,143206,274795,-19208,0.451238196,0.521137575,-0.06989938
Washington,53013,Columbia County,1737,661,2476,1076,0.701534733,0.266962843,0.43457189
Washington,53015,Cowlitz County,34580,22825,59020,11755,0.585903084,0.386733311,0.199169773
Washington,53017,Douglas County,13095,7410,21069,5685,0.621529261,0.351701552,0.269827709
Washington,53019,Ferry County,2667,1315,4096,1352,0.651123047,0.321044922,0.330078125
Washington,53021,Franklin County,19086,11884,31739,7202,0.601342197,0.374428936,0.226913261
Washington,53023,Garfield County,973,330,1343,643,0.724497394,0.245718541,0.478778853
Washington,53025,Grant County,24326,10806,36069,13520,0.674429566,0.299592448,0.374837118
Washington,53027,Grays Harbor County,19432,17161,37638,2271,0.516286731,0.455948775,0.060337956
Washington,53029,Island County,20967,29595,52075,-8628,0.402630821,0.56831493,-0.165684109
Washington,53031,Jefferson County,6324,17459,24572,-11135,0.257366108,0.710524174,-0.453158066
Washington,53033,King County,252193,832606,1122881,-580413,0.224594592,0.741490861,-0.51689627
Washington,53035,Kitsap County,59080,91731,155893,-32651,0.378977889,0.588422828,-0.20944494
Washington,53037,Kittitas County,14645,10810,26309,3835,0.556653617,0.410886009,0.145767608
Washington,53039,Klickitat County,7178,5917,13527,1261,0.530642419,0.437421453,0.093220965
Washington,53041,Lewis County,29322,14433,45112,14889,0.649982266,0.319937046,0.330045221
Washington,53043,Lincoln County,5272,1678,7107,3594,0.741803855,0.236105248,0.505698607
Washington,53045,Mason County,18127,17215,36502,912,0.496602926,0.471617994,0.024984932
Washington,53047,Okanogan County,11555,8466,20617,3089,0.560459815,0.410632003,0.149827812
Washington,53049,Pacific County,7010,6825,14178,185,0.494427987,0.481379602,0.013048385
Washington,53051,Pend Oreille County,5826,2461,8497,3365,0.68565376,0.289631635,0.396022125
Washington,53053,Pierce County,188194,235169,436685,-46975,0.430960532,0.538532352,-0.10757182
Washington,53055,San Juan County,2890,9539,12939,-6649,0.223355746,0.737228534,-0.513872788
Washington,53057,Skagit County,30765,36956,69837,-6191,0.440525796,0.529175079,-0.088649283
Washington,53059,Skamania County,3961,3147,7314,814,0.541564124,0.430270714,0.11129341
Washington,53061,Snohomish County,161371,240099,415327,-78728,0.388539633,0.578096295,-0.189556663
Washington,53063,Spokane County,145338,131163,284958,14175,0.510033058,0.460288885,0.049744173
Washington,53065,Stevens County,19895,7492,28095,12403,0.70813312,0.266666667,0.441466453
Washington,53067,Thurston County,62282,95663,163637,-33381,0.380610742,0.584604949,-0.203994207
Washington,53069,Wahkiakum County,1757,1204,3053,553,0.575499509,0.394366197,0.181133311
Washington,53071,Walla Walla County,15476,13106,29373,2370,0.526878426,0.446192081,0.080686345
Washington,53073,Whatcom County,49213,83295,137006,-34082,0.359203247,0.607966074,-0.248762828
Washington,53075,Whitman County,8699,10480,19845,-1781,0.438347191,0.528092719,-0.089745528
Washington,53077,Yakima County,49368,36706,88280,12662,0.559220662,0.415790666,0.143429995
West Virginia,54001,Barbour County,5071,1199,6395,3872,0.792963253,0.187490227,0.605473026
West Virginia,54003,Berkeley County,37580,17500,56102,20080,0.669851342,0.311931838,0.357919504
West Virginia,54005,Boone County,6314,1641,8142,4673,0.775485139,0.201547531,0.573937607
West Virginia,54007,Braxton County,3991,1233,5313,2758,0.75117636,0.232072276,0.519104084
West Virginia,54009,Brooke County,6986,2621,9782,4365,0.714168882,0.267941116,0.446227765
West Virginia,54011,Cabell County,21229,13474,35429,7755,0.599198397,0.380309916,0.218888481
West Virginia,54013,Calhoun County,2391,488,2936,1903,0.814373297,0.166212534,0.648160763
West Virginia,54015,Clay County,2597,580,3240,2017,0.80154321,0.179012346,0.622530864
West Virginia,54017,Doddridge County,2541,374,2956,2167,0.859607578,0.126522327,0.73308525
West Virginia,54019,Fayette County,10910,4387,15620,6523,0.698463508,0.280857875,0.417605634
West Virginia,54021,Gilmer County,1822,486,2344,1336,0.777303754,0.207337884,0.56996587
West Virginia,54023,Grant County,4949,552,5568,4397,0.888829023,0.099137931,0.789691092
West Virginia,54025,Greenbrier County,10517,4196,14996,6321,0.701320352,0.279807949,0.421512403
West Virginia,54027,Hampshire County,8464,1890,10500,6574,0.806095238,0.18,0.626095238
West Virginia,54029,Hancock County,9462,3360,13030,6102,0.726170376,0.257866462,0.468303914
West Virginia,54031,Hardy County,4997,1297,6411,3700,0.779441585,0.202308532,0.577133053
West Virginia,54033,Harrison County,20480,8402,29495,12078,0.694354975,0.284861841,0.409493134
West Virginia,54035,Jackson County,9907,2699,12822,7208,0.772656372,0.210497582,0.56215879
West Virginia,54037,Jefferson County,16573,11967,29156,4606,0.568425024,0.410447249,0.157977775
West Virginia,54039,Kanawha County,43352,30231,75239,13121,0.576190539,0.401799599,0.174390941
West Virginia,54041,Lewis County,5550,1372,7048,4178,0.787457435,0.194665153,0.592792281
West Virginia,54043,Lincoln County,5770,1279,7187,4491,0.802838458,0.177960206,0.624878252
West Virginia,54045,Logan County,9500,1848,11469,7652,0.828319819,0.161130003,0.667189816
West Virginia,54047,McDowell County,4310,1036,5425,3274,0.794470046,0.190967742,0.603502304
West Virginia,54049,Marion County,15881,8185,24634,7696,0.644678087,0.33226435,0.312413737
West Virginia,54051,Marshall County,9808,3186,13233,6622,0.74117736,0.240761732,0.500415628
West Virginia,54053,Mason County,8232,2111,10547,6121,0.780506305,0.200151702,0.580354603
West Virginia,54055,Mercer County,18372,4851,23584,13521,0.779002714,0.205690299,0.573312415
West Virginia,54057,Mineral County,10247,2483,12904,7764,0.794094854,0.192420955,0.6016739
West Virginia,54059,Mingo County,7325,1061,8490,6264,0.862779741,0.124970554,0.737809187
West Virginia,54061,Monongalia County,21084,19265,41452,1819,0.508636495,0.464754415,0.04388208
West Virginia,54063,Monroe County,5089,1155,6367,3934,0.799277525,0.181404115,0.61787341
West Virginia,54065,Morgan County,7009,1947,9097,5062,0.770473783,0.214026602,0.55644718
West Virginia,54067,Nicholas County,7960,1919,10037,6041,0.793065657,0.191192587,0.60187307
West Virginia,54069,Ohio County,11593,6727,18689,4866,0.620311413,0.359944352,0.260367061
West Virginia,54071,Pendleton County,2687,680,3425,2007,0.784525547,0.198540146,0.585985401
West Virginia,54073,Pleasants County,2632,656,3348,1976,0.78614098,0.195937873,0.590203106
West Virginia,54075,Pocahontas County,2889,927,3901,1962,0.740579339,0.237631377,0.502947962
West Virginia,54077,Preston County,11176,2953,14426,8223,0.774712325,0.204699847,0.570012477
West Virginia,54079,Putnam County,19868,7124,27507,12744,0.722288872,0.258988621,0.463300251
West Virginia,54081,Raleigh County,23644,6816,30966,16828,0.763547116,0.220112381,0.543434735
West Virginia,54083,Randolph County,8356,3008,11594,5348,0.720717613,0.25944454,0.461273072
West Virginia,54085,Ritchie County,3473,517,4050,2956,0.857530864,0.127654321,0.729876543
West Virginia,54087,Roane County,4189,1218,5521,2971,0.758739359,0.220612208,0.538127151
West Virginia,54089,Summers County,3931,1226,5264,2705,0.746770517,0.232902736,0.513867781
West Virginia,54091,Taylor County,5422,1694,7265,3728,0.746317963,0.233172746,0.513145217
West Virginia,54093,Tucker County,2669,890,3636,1779,0.734048405,0.244774477,0.489273927
West Virginia,54095,Tyler County,2991,554,3617,2437,0.826928394,0.153165607,0.673762787
West Virginia,54097,Upshur County,7633,2033,9859,5600,0.774216452,0.206207526,0.568008926
West Virginia,54099,Wayne County,11934,3532,15747,8402,0.75785864,0.224296691,0.533561948
West Virginia,54101,Webster County,2478,479,2998,1999,0.826551034,0.159773182,0.666777852
West Virginia,54103,Wetzel County,4718,1294,6168,3424,0.764915694,0.209792477,0.555123217
West Virginia,54105,Wirt County,2120,409,2581,1711,0.821387059,0.158465711,0.662921348
West Virginia,54107,Wood County,26380,10317,37313,16063,0.706992201,0.276498807,0.430493394
West Virginia,54109,Wyoming County,6503,980,7565,5523,0.859616656,0.129543952,0.730072703
Wisconsin,55001,Adams County,7763,4443,12853,3320,0.603983506,0.345678052,0.258305454
Wisconsin,55003,Ashland County,4191,4612,8933,-421,0.469159297,0.516287921,-0.047128624
Wisconsin,55005,Barron County,16726,8941,26775,7785,0.624687208,0.333930906,0.290756303
Wisconsin,55007,Bayfield County,4860,6107,11204,-1247,0.433773652,0.545073188,-0.111299536
Wisconsin,55009,Brown County,79132,67937,148960,11195,0.53122986,0.456075456,0.075154404
Wisconsin,55011,Buffalo County,5213,2765,8091,2448,0.644296132,0.341737733,0.302558398
Wisconsin,55013,Burnett County,7008,3665,10807,3343,0.648468585,0.339132044,0.309336541
Wisconsin,55015,Calumet County,19488,12927,32860,6561,0.593061473,0.393396226,0.199665247
Wisconsin,55017,Chippewa County,23399,14573,38400,8826,0.609348958,0.379505208,0.22984375
Wisconsin,55019,Clark County,10481,4509,15315,5972,0.684361737,0.294417238,0.389944499
Wisconsin,55021,Columbia County,17988,16388,34843,1600,0.516258646,0.470338375,0.045920271
Wisconsin,55023,Crawford County,5113,3860,9084,1253,0.562857772,0.424922941,0.13793483
Wisconsin,55025,Dane County,85454,273995,364840,-188541,0.234223221,0.751000439,-0.516777217
Wisconsin,55027,Dodge County,33067,16518,50292,16549,0.657500199,0.328441899,0.3290583
Wisconsin,55029,Door County,10099,10565,20896,-466,0.483298239,0.505599158,-0.022300919
Wisconsin,55031,Douglas County,11732,13073,25165,-1341,0.46620306,0.519491357,-0.053288297
Wisconsin,55033,Dunn County,14726,10643,25674,4083,0.573576381,0.414543897,0.159032484
Wisconsin,55035,Eau Claire County,27728,34400,63003,-6672,0.440106027,0.546005746,-0.105899719
Wisconsin,55037,Florence County,2356,783,3158,1573,0.746041799,0.247941735,0.498100063
Wisconsin,55039,Fond du Lac County,37272,20495,58438,16777,0.637804169,0.350713577,0.287090592
Wisconsin,55041,Forest County,3382,1681,5095,1701,0.663788027,0.329931305,0.333856722
Wisconsin,55043,Grant County,15922,10966,27254,4956,0.584207823,0.402362956,0.181844867
Wisconsin,55045,Green County,10843,10903,22026,-60,0.492281849,0.495005902,-0.002724053
Wisconsin,55047,Green Lake County,7458,3449,11033,4009,0.675972084,0.312607632,0.363364452
Wisconsin,55049,Iowa County,6631,7750,14647,-1119,0.452720694,0.529118591,-0.076397897
Wisconsin,55051,Iron County,2557,1487,4079,1070,0.626869331,0.364550135,0.262319196
Wisconsin,55053,Jackson County,6204,4157,10501,2047,0.590800876,0.39586706,0.194933816
Wisconsin,55055,Jefferson County,28771,20574,50035,8197,0.575017488,0.411192165,0.163825322
Wisconsin,55057,Juneau County,9525,4854,14528,4671,0.655630507,0.334113436,0.32151707
Wisconsin,55059,Kenosha County,47478,41826,90472,5652,0.524781148,0.462308781,0.062472367
Wisconsin,55061,Kewaunee County,8267,4059,12466,4208,0.663163806,0.325605647,0.337558158
Wisconsin,55063,La Crosse County,32247,39008,72242,-6761,0.446374685,0.539962902,-0.093588217
Wisconsin,55065,Lafayette County,5256,3469,8832,1787,0.595108696,0.392776268,0.202332428
Wisconsin,55067,Langlade County,7782,3746,11659,4036,0.667467193,0.321296852,0.346170341
Wisconsin,55069,Lincoln County,10633,6306,17188,4327,0.618629276,0.366883872,0.251745404
Wisconsin,55071,Manitowoc County,28200,17399,46235,10801,0.609927544,0.376316643,0.233610901
Wisconsin,55073,Marathon County,46213,31529,78675,14684,0.587391166,0.400749921,0.186641246
Wisconsin,55075,Marinette County,16670,7415,24364,9255,0.684206206,0.304342473,0.379863733
Wisconsin,55077,Marquette County,6041,3252,9406,2789,0.642249628,0.345736764,0.296512864
Wisconsin,55078,Menominee County,296,1266,1572,-970,0.188295165,0.805343511,-0.617048346
Wisconsin,55079,Milwaukee County,138022,316292,462766,-178270,0.298254409,0.6834815,-0.385227091
Wisconsin,55081,Monroe County,14563,8476,23321,6087,0.624458642,0.363449252,0.261009391
Wisconsin,55083,Oconto County,17675,6967,24881,10708,0.710381416,0.280012861,0.430368554
Wisconsin,55085,Oneida County,14455,10080,24837,4375,0.581994605,0.405846117,0.176148488
Wisconsin,55087,Outagamie County,60827,49438,111905,11389,0.543559269,0.441785443,0.101773826
Wisconsin,55089,Ozaukee County,34504,27874,63199,6630,0.545958006,0.441051282,0.104906723
Wisconsin,55091,Pepin County,2798,1523,4354,1275,0.642627469,0.349793294,0.292834175
Wisconsin,55093,Pierce County,14417,10171,25320,4246,0.569391785,0.401698262,0.167693523
Wisconsin,55095,Polk County,18296,9567,28212,8729,0.648518361,0.339111017,0.309407344
Wisconsin,55097,Portage County,20987,21503,43158,-516,0.48628296,0.498239029,-0.011956068
Wisconsin,55099,Price County,5763,3005,8856,2758,0.650745257,0.339317977,0.311427281
Wisconsin,55101,Racine County,56347,49721,107402,6626,0.524636413,0.462942962,0.061693451
Wisconsin,55103,Richland County,5207,3985,9305,1222,0.559591617,0.428264374,0.131327243
Wisconsin,55105,Rock County,40218,46642,88113,-6424,0.456436621,0.529343003,-0.072906382
Wisconsin,55107,Rusk County,5660,2516,8261,3144,0.685147077,0.304563612,0.380583464
Wisconsin,55109,St. Croix County,35537,23870,60477,11667,0.587611819,0.394695504,0.192916315
Wisconsin,55111,Sauk County,18798,18172,37574,626,0.500292756,0.483632299,0.016660457
Wisconsin,55113,Sawyer County,6422,4599,11122,1823,0.577414134,0.413504765,0.163909369
Wisconsin,55115,Shawano County,15850,7336,23455,8514,0.675762098,0.312769132,0.362992965
Wisconsin,55117,Sheboygan County,38763,27735,67410,11028,0.575033378,0.411437472,0.163595906
Wisconsin,55119,Taylor County,8209,2823,11172,5386,0.734783387,0.252685285,0.482098102
Wisconsin,55121,Trempealeau County,9661,6219,16066,3442,0.601332005,0.387090751,0.214241255
Wisconsin,55123,Vernon County,8807,7514,16579,1293,0.531214187,0.453223958,0.077990229
Wisconsin,55125,Vilas County,9837,6119,16101,3718,0.610955841,0.380038507,0.230917334
Wisconsin,55127,Walworth County,36603,23161,60465,13442,0.605358472,0.383048044,0.222310428
Wisconsin,55129,Washburn County,6962,3867,10953,3095,0.635624943,0.353053958,0.282570985
Wisconsin,55131,Washington County,61604,28504,91162,33100,0.675764024,0.312674141,0.363089884
Wisconsin,55133,Waukesha County,162768,108478,274845,54290,0.592217432,0.394687915,0.197529517
Wisconsin,55135,Waupaca County,20093,9947,30367,10146,0.66167221,0.327559522,0.334112688
Wisconsin,55137,Waushara County,9625,4571,14360,5054,0.670264624,0.318314763,0.351949861
Wisconsin,55139,Winnebago County,49179,44660,95166,4519,0.516770695,0.469285249,0.047485446
Wisconsin,55141,Wood County,24997,16599,42149,8398,0.593062706,0.393817172,0.199245534
Wyoming,56001,Albany County,8930,8371,17639,559,0.506264527,0.474573389,0.031691139
Wyoming,56003,Big Horn County,4867,742,5691,4125,0.855209981,0.130381304,0.724828677
Wyoming,56005,Campbell County,16006,2004,18236,14002,0.877714411,0.10989252,0.767821891
Wyoming,56007,Carbon County,4952,1274,6327,3678,0.782677414,0.201359254,0.58131816
Wyoming,56009,Converse County,5756,845,6678,4911,0.861934711,0.126534891,0.73539982
Wyoming,56011,Crook County,3805,443,4311,3362,0.882625841,0.10276038,0.77986546
Wyoming,56013,Fremont County,11552,5179,17060,6373,0.677139508,0.303575615,0.373563892
Wyoming,56015,Goshen County,4893,1156,6134,3737,0.797685034,0.188457776,0.609227258
Wyoming,56017,Hot Springs County,2082,488,2604,1594,0.799539171,0.187403994,0.612135177
Wyoming,56019,Johnson County,3936,847,4851,3089,0.811379097,0.174603175,0.636775922
Wyoming,56021,Laramie County,28063,14153,42899,13910,0.654164433,0.32991445,0.324249983
Wyoming,56023,Lincoln County,8957,1623,10731,7334,0.834684559,0.151244059,0.683440499
Wyoming,56025,Natrona County,24671,8337,33591,16334,0.734452681,0.24819148,0.486261201
Wyoming,56027,Niobrara County,1108,112,1230,996,0.900813008,0.091056911,0.809756098
Wyoming,56029,Park County,13084,3259,16575,9825,0.789381599,0.196621418,0.592760181
Wyoming,56031,Platte County,3874,780,4727,3094,0.819547282,0.16500952,0.654537762
Wyoming,56033,Sheridan County,12041,3920,16219,8121,0.742400888,0.241691843,0.500709045
Wyoming,56035,Sublette County,3905,920,4885,2985,0.799385875,0.188331627,0.611054248
Wyoming,56037,Sweetwater County,12541,3731,16569,8810,0.756895407,0.225179552,0.531715855
Wyoming,56039,Teton County,4134,8748,13077,-4614,0.316127552,0.668960771,-0.352833219
Wyoming,56041,Uinta County,7282,1561,8984,5721,0.810552093,0.173753339,0.636798753
Wyoming,56043,Washakie County,3125,656,3841,2469,0.813590211,0.170788857,0.642801354
Wyoming,56045,Weston County,3069,378,3494,2691,0.878362908,0.108185461,0.770177447
